nabab	nabab	Nom:Mas+SG
nababs	nabab	Nom:Mas+PL
nabote	nabot	Adj:Fem+SG
nabote	nabot	Nom:Fem+SG
nabotes	nabot	Adj:Fem+PL
nabotes	nabot	Nom:Fem+PL
nabot	nabot	Adj:Mas+SG
nabot	nabot	Nom:Mas+SG
nabots	nabot	Adj:Mas+PL
nabots	nabot	Nom:Mas+PL
nabuchodonosor	nabuchodonosor	Nom:Mas+SG
nacarat	nacarat	Adj:InvGen+SG:InvGen+PL
nacarat	nacarat	Nom:Mas+SG
nacelle	nacelle	Nom:Fem+SG
nacelles	nacelle	Nom:Fem+PL
nacraient	nacrer	Ver:IImp+PL+P3
nacrai	nacrer	Ver:IPSim+SG+P1
nacrais	nacrer	Ver:IImp+SG+P1:IImp+SG+P2
nacrait	nacrer	Ver:IImp+SG+P3
nacrâmes	nacrer	Ver:IPSim+PL+P1
nacra	nacrer	Ver:IPSim+SG+P3
nacrant	nacrer	Ver:PPre
nacras	nacrer	Ver:IPSim+SG+P2
nacrasse	nacrer	Ver:SImp+SG+P1
nacrassent	nacrer	Ver:SImp+PL+P3
nacrasses	nacrer	Ver:SImp+SG+P2
nacrassiez	nacrer	Ver:SImp+PL+P2
nacrassions	nacrer	Ver:SImp+PL+P1
nacrâtes	nacrer	Ver:IPSim+PL+P2
nacrât	nacrer	Ver:SImp+SG+P3
nacrée	nacré	Adj:Fem+SG
nacrée	nacrer	Ver:PPas+Fem+SG
nacrées	nacré	Adj:Fem+PL
nacrées	nacrer	Ver:PPas+Fem+PL
nacré	nacré	Adj:Mas+SG
nacre	nacre	Nom:Fem+SG
nacré	nacré	Nom:Mas+SG
nacre	nacrer	Ver:IPre+SG+P1:IPre+SG+P3:SPre+SG+P1:SPre+SG+P3:ImPre+SG+P2
nacré	nacrer	Ver:PPas+Mas+SG
nacrent	nacrer	Ver:IPre+PL+P3:SPre+PL+P3
nacreraient	nacrer	Ver:CPre+PL+P3
nacrerai	nacrer	Ver:IFut+SG+P1
nacrerais	nacrer	Ver:CPre+SG+P1:CPre+SG+P2
nacrerait	nacrer	Ver:CPre+SG+P3
nacrera	nacrer	Ver:IFut+SG+P3
nacreras	nacrer	Ver:IFut+SG+P2
nacrèrent	nacrer	Ver:IPSim+PL+P3
nacrerez	nacrer	Ver:IFut+PL+P2
nacreriez	nacrer	Ver:CPre+PL+P2
nacrerions	nacrer	Ver:CPre+PL+P1
nacrer	nacrer	Ver:Inf
nacrerons	nacrer	Ver:IFut+PL+P1
nacreront	nacrer	Ver:IFut+PL+P3
nacrés	nacré	Adj:Mas+PL
nacres	nacre	Nom:Fem+PL
nacrés	nacré	Nom:Mas+PL
nacres	nacrer	Ver:IPre+SG+P2:SPre+SG+P2
nacrés	nacrer	Ver:PPas+Mas+PL
nacrez	nacrer	Ver:IPre+PL+P2:ImPre+PL+P2
nacriez	nacrer	Ver:IImp+PL+P2:SPre+PL+P2
nacrions	nacrer	Ver:IImp+PL+P1:SPre+PL+P1
nacrons	nacrer	Ver:IPre+PL+P1:ImPre+PL+P1
nadir	nadir	Nom:Mas+SG
naevi	naevus	Nom:Mas+PL
naevus	naevus	Nom:Mas+SG
nafé	nafé	Nom:Mas+SG
nagaïka	nagaïka	Nom:Fem+SG
nagari	nagari	Adj:InvGen+SG
nagari	nagari	Nom:Fem+SG
nageaient	nager	Ver:IImp+PL+P3
nageai	nager	Ver:IPSim+SG+P1
nageais	nager	Ver:IImp+SG+P1:IImp+SG+P2
nageait	nager	Ver:IImp+SG+P3
nageâmes	nager	Ver:IPSim+PL+P1
nagea	nager	Ver:IPSim+SG+P3
nageant	nageant	Adj:Mas+SG
nageant	nager	Ver:PPre
nageas	nager	Ver:IPSim+SG+P2
nageasse	nager	Ver:SImp+SG+P1
nageassent	nager	Ver:SImp+PL+P3
nageasses	nager	Ver:SImp+SG+P2
nageassiez	nager	Ver:SImp+PL+P2
nageassions	nager	Ver:SImp+PL+P1
nageâtes	nager	Ver:IPSim+PL+P2
nageât	nager	Ver:SImp+SG+P3
nagée	nager	Ver:PPas+Fem+SG
nagées	nager	Ver:PPas+Fem+PL
nage	nage	Nom:Fem+SG
nagé	nager	Ver:PPas+Mas+SG
nagent	nager	Ver:IPre+PL+P3:SPre+PL+P3
nageoire	nageoire	Nom:Fem+SG
nageoires	nageoire	Nom:Fem+PL
nageons	nager	Ver:IPre+PL+P1:ImPre+PL+P1
nageraient	nager	Ver:CPre+PL+P3
nagerai	nager	Ver:IFut+SG+P1
nagerais	nager	Ver:CPre+SG+P1:CPre+SG+P2
nagerait	nager	Ver:CPre+SG+P3
nagera	nager	Ver:IFut+SG+P3
nageras	nager	Ver:IFut+SG+P2
nagèrent	nager	Ver:IPSim+PL+P3
nagerez	nager	Ver:IFut+PL+P2
nageriez	nager	Ver:CPre+PL+P2
nagerions	nager	Ver:CPre+PL+P1
nager	nager	Ver:Inf
nagerons	nager	Ver:IFut+PL+P1
nageront	nager	Ver:IFut+PL+P3
nages	nage	Nom:Fem+PL
nagés	nager	Ver:PPas+Mas+PL
nageur	nageur	Adj:Mas+SG
nageur	nageur	Nom:Mas+SG
nageurs	nageur	Adj:Mas+PL
nageurs	nageur	Nom:Mas+PL
nageuse	nageur	Adj:Fem+SG
nageuse	nageur	Nom:Fem+SG
nageuses	nageur	Adj:Fem+PL
nageuses	nageur	Nom:Fem+PL
nagez	nager	Ver:IPre+PL+P2:ImPre+PL+P2
nagiez	nager	Ver:IImp+PL+P2:SPre+PL+P2
nagions	nager	Ver:IImp+PL+P1:SPre+PL+P1
naguère	naguère	Adv
nahaïka	nahaïka	Nom:Fem+SG
nahua	nahua	Adj:InvGen+SG
nahua	nahua	Nom:InvGen+SG
nahua	nahua	Nom:Mas+SG
naïade	naïade	Nom:Fem+SG
naïades	naïade	Nom:Fem+PL
naïf	naïf	Adj:Mas+SG
naïf	naïf	Nom:Mas+SG
naïfs	naïf	Adj:Mas+PL
naïfs	naïf	Nom:Mas+PL
naine	nain	Adj:Fem+SG
naine	nain	Nom:Fem+SG
naines	nain	Adj:Fem+PL
naines	nain	Nom:Fem+PL
nain	nain	Adj:Mas+SG
nains	nain	Adj:Mas+PL
naira	naira	Nom:Mas+SG
nais	naître	Ver:IPre+SG+P1:IPre+SG+P2:ImPre+SG+P2
naissaient	naître	Ver:IImp+PL+P3
naissain	naissain	Nom:Mas+SG
naissais	naître	Ver:IImp+SG+P1:IImp+SG+P2
naissait	naître	Ver:IImp+SG+P3
naissance	naissance	Nom:Fem+SG
naissances	naissance	Nom:Fem+PL
naissante	naissant	Adj:Fem+SG
naissantes	naissant	Adj:Fem+PL
naissant	naissant	Adj:Mas+SG
naissant	naître	Ver:PPre
naissants	naissant	Adj:Mas+PL
naisse	naître	Ver:SPre+SG+P1:SPre+SG+P3
naissent	naître	Ver:IPre+PL+P3:SPre+PL+P3
naisses	naître	Ver:SPre+SG+P2
naisseur	naisseur	Nom:Mas+SG
naissez	naître	Ver:IPre+PL+P2:ImPre+PL+P2
naissiez	naître	Ver:IImp+PL+P2:SPre+PL+P2
naissions	naître	Ver:IImp+PL+P1:SPre+PL+P1
naissons	naître	Ver:IPre+PL+P1:ImPre+PL+P1
naît	naître	Ver:IPre+SG+P3
naîtraient	naître	Ver:CPre+PL+P3
naîtrai	naître	Ver:IFut+SG+P1
naîtrais	naître	Ver:CPre+SG+P1:CPre+SG+P2
naîtrait	naître	Ver:CPre+SG+P3
naîtra	naître	Ver:IFut+SG+P3
naîtras	naître	Ver:IFut+SG+P2
naître	naître	Ver:Inf
naîtrez	naître	Ver:IFut+PL+P2
naîtriez	naître	Ver:CPre+PL+P2
naîtrions	naître	Ver:CPre+PL+P1
naîtrons	naître	Ver:IFut+PL+P1
naîtront	naître	Ver:IFut+PL+P3
naïvement	naïvement	Adv
naïve	naïf	Adj:Fem+SG
naïve	naïf	Nom:Fem+SG
naïves	naïf	Adj:Fem+PL
naïves	naïf	Nom:Fem+PL
naïveté	naïveté	Nom:Fem+SG
naïvetés	naïveté	Nom:Fem+PL
naja	naja	Nom:Mas+SG
najas	naja	Nom:Mas+PL
na	na	Int
nana	nana	Nom:Fem+SG
nanan	nanan	Nom:Mas+SG
nanar	nanar	Nom:Mas+SG
nancéien	nancéien	Adj:Mas+SG
nancéienne	nancéien	Adj:Fem+SG
nancéienne	nancéien	Nom:Fem+SG
nancéiennes	nancéien	Adj:Fem+PL
nancéiennes	nancéien	Nom:Fem+PL
nancéiens	nancéien	Adj:Mas+PL
nandou	nandou	Nom:Mas+SG
nanisme	nanisme	Nom:Mas+SG
nanismes	nanisme	Nom:Mas+PL
nankin	nankin	Nom:Mas+SG
nanocéphale	nanocéphale	Adj:InvGen+SG
nansouk	nansouk	Nom:Mas+SG
nantaise	nantais	Adj:Fem+SG
nantais	nantais	Adj:Mas+InvPL
nantais	nantais	Nom:Mas+InvPL
nantie	nanti	Adj:Fem+SG
nantie	nanti	Nom:Fem+SG
nantie	nantir	Ver:PPas+Fem+SG
nanties	nanti	Adj:Fem+PL
nanties	nanti	Nom:Fem+PL
nanties	nantir	Ver:PPas+Fem+PL
nantîmes	nantir	Ver:IPSim+PL+P1
nanti	nanti	Adj:Mas+SG
nanti	nanti	Nom:Mas+SG
nanti	nantir	Ver:PPas+Mas+SG
nantiraient	nantir	Ver:CPre+PL+P3
nantirai	nantir	Ver:IFut+SG+P1
nantirais	nantir	Ver:CPre+SG+P1:CPre+SG+P2
nantirait	nantir	Ver:CPre+SG+P3
nantira	nantir	Ver:IFut+SG+P3
nantiras	nantir	Ver:IFut+SG+P2
nantirent	nantir	Ver:IPSim+PL+P3
nantirez	nantir	Ver:IFut+PL+P2
nantiriez	nantir	Ver:CPre+PL+P2
nantirions	nantir	Ver:CPre+PL+P1
nantir	nantir	Ver:Inf
nantirons	nantir	Ver:IFut+PL+P1
nantiront	nantir	Ver:IFut+PL+P3
nantis	nanti	Adj:Mas+PL
nantis	nanti	Nom:Mas+PL
nantis	nantir	Ver:PPas+Mas+PL:IPre+SG+P1:IPre+SG+P2:IPSim+SG+P1:IPSim+SG+P2:ImPre+SG+P2
nantissaient	nantir	Ver:IImp+PL+P3
nantissais	nantir	Ver:IImp+SG+P1:IImp+SG+P2
nantissait	nantir	Ver:IImp+SG+P3
nantissant	nantir	Ver:PPre
nantissant	nantir	Ver:PPre
nantissant	nantir	Ver:PPre+Mas+SG
nantissement	nantissement	Nom:Mas+SG
nantissements	nantissement	Nom:Mas+PL
nantisse	nantir	Ver:SPre+SG+P1:SPre+SG+P3:SImp+SG+P1
nantissent	nantir	Ver:IPre+PL+P3:SPre+PL+P3:SImp+PL+P3
nantisses	nantir	Ver:SPre+SG+P2:SImp+SG+P2
nantissez	nantir	Ver:IPre+PL+P2:ImPre+PL+P2
nantissiez	nantir	Ver:IImp+PL+P2:SPre+PL+P2:SImp+PL+P2
nantissions	nantir	Ver:IImp+PL+P1:SPre+PL+P1:SImp+PL+P1
nantissons	nantir	Ver:IPre+PL+P1:ImPre+PL+P1
nantîtes	nantir	Ver:IPSim+PL+P2
nantit	nantir	Ver:IPre+SG+P3:IPSim+SG+P3
nantît	nantir	Ver:SImp+SG+P3
nanzouk	nanzouk	Nom:Mas+SG
naos	naos	Nom:Mas+InvPL
napalm	napalm	Nom:Mas+SG
napalms	napalm	Nom:Mas+PL
napée	napée	Nom:Fem+SG
napel	napel	Nom:Mas+SG
naphtalène	naphtalène	Nom:Mas+SG
naphtaline	naphtaline	Nom:Fem+SG
naphtaline	naphtaliner	Ver:IPre+SG+P1:IPre+SG+P3:SPre+SG+P1:SPre+SG+P3:ImPre+SG+P2
naphta	naphta	Nom:Mas+SG
naphtazoline	naphtazoline	Nom:Fem+SG
naphte	naphte	Nom:Mas+SG
naphtes	naphte	Nom:Mas+PL
naphtol	naphtol	Nom:Mas+SG
napoléonien	napoléonien	Adj:Mas+SG
napoléonienne	napoléonien	Adj:Fem+SG
napoléoniennes	napoléonien	Adj:Fem+PL
napoléoniens	napoléonien	Adj:Mas+PL
napoléon	napoléon	Nom:Mas+SG
napoléons	napoléon	Nom:Mas+PL
napolitaine	napolitain	Adj:Fem+SG
napolitaine	napolitaine	Nom:Fem+SG
napolitaine	napolitain	Nom:Fem+SG
napolitaines	napolitain	Adj:Fem+PL
napolitaines	napolitaine	Nom:Fem+PL
napolitaines	napolitain	Nom:Fem+PL
napolitain	napolitain	Adj:Mas+SG
napolitain	napolitain	Nom:Mas+SG
napolitains	napolitain	Adj:Mas+PL
nappage	nappage	Nom:Mas+SG
nappages	nappage	Nom:Mas+PL
nappaient	napper	Ver:IImp+PL+P3
nappai	napper	Ver:IPSim+SG+P1
nappais	napper	Ver:IImp+SG+P1:IImp+SG+P2
nappait	napper	Ver:IImp+SG+P3
nappâmes	napper	Ver:IPSim+PL+P1
nappa	napper	Ver:IPSim+SG+P3
nappant	napper	Ver:PPre
nappas	napper	Ver:IPSim+SG+P2
nappasse	napper	Ver:SImp+SG+P1
nappassent	napper	Ver:SImp+PL+P3
nappasses	napper	Ver:SImp+SG+P2
nappassiez	napper	Ver:SImp+PL+P2
nappassions	napper	Ver:SImp+PL+P1
nappâtes	napper	Ver:IPSim+PL+P2
nappât	napper	Ver:SImp+SG+P3
nappée	napper	Ver:PPas+Fem+SG
nappées	napper	Ver:PPas+Fem+PL
nappe	nappe	Nom:Fem+SG
nappé	napper	Ver:PPas+Mas+SG
nappent	napper	Ver:IPre+PL+P3:SPre+PL+P3
napperaient	napper	Ver:CPre+PL+P3
napperai	napper	Ver:IFut+SG+P1
napperais	napper	Ver:CPre+SG+P1:CPre+SG+P2
napperait	napper	Ver:CPre+SG+P3
nappera	napper	Ver:IFut+SG+P3
napperas	napper	Ver:IFut+SG+P2
nappèrent	napper	Ver:IPSim+PL+P3
napperez	napper	Ver:IFut+PL+P2
napperiez	napper	Ver:CPre+PL+P2
napperions	napper	Ver:CPre+PL+P1
napper	napper	Ver:Inf
napperon	napperon	Nom:Mas+SG
napperons	napperon	Nom:Mas+PL
napperons	napper	Ver:IFut+PL+P1
napperont	napper	Ver:IFut+PL+P3
nappes	nappe	Nom:Fem+PL
nappes	napper	Ver:IPre+SG+P2:SPre+SG+P2
nappés	napper	Ver:PPas+Mas+PL
nappez	napper	Ver:IPre+PL+P2:ImPre+PL+P2
nappiez	napper	Ver:IImp+PL+P2:SPre+PL+P2
nappions	napper	Ver:IImp+PL+P1:SPre+PL+P1
nappons	napper	Ver:IPre+PL+P1:ImPre+PL+P1
naquîmes	naître	Ver:IPSim+PL+P1
naquirent	naître	Ver:IPSim+PL+P3
naquis	naître	Ver:IPSim+SG+P1:IPSim+SG+P2
naquisse	naître	Ver:SImp+SG+P1
naquissent	naître	Ver:SImp+PL+P3
naquisses	naître	Ver:SImp+SG+P2
naquissiez	naître	Ver:SImp+PL+P2
naquissions	naître	Ver:SImp+PL+P1
naquîtes	naître	Ver:IPSim+PL+P2
naquit	naître	Ver:IPSim+SG+P3
naquît	naître	Ver:SImp+SG+P3
narbonnaise	narbonnais	Adj:Fem+SG
narbonnais	narbonnais	Adj:Mas+InvPL
narcéine	narcéine	Nom:Fem+SG
narcisse	narcisse	Nom:Mas+SG
narcisses	narcisse	Nom:Mas+PL
narcissique	narcissique	Adj:InvGen+SG
narcissiques	narcissique	Adj:InvGen+PL
narcissisme	narcissisme	Nom:Mas+SG
narcolepsie	narcolepsie	Nom:Fem+SG
narcoleptique	narcoleptique	Adj:InvGen+SG
narcose	narcose	Nom:Fem+SG
narcothérapie	narcothérapie	Nom:Fem+SG
narcotine	narcotine	Nom:Fem+SG
narcotique	narcotique	Adj:InvGen+SG
narcotique	narcotique	Nom:Mas+SG
narcotiques	narcotique	Adj:InvGen+PL
narcotiques	narcotique	Nom:Mas+PL
nard	nard	Nom:Mas+SG
nards	nard	Nom:Mas+PL
narghileh	narghileh	Nom:Mas+SG
narghilé	narghilé	Nom:Mas+SG
narghilés	narghilé	Nom:Mas+PL
narguaient	narguer	Ver:IImp+PL+P3
narguai	narguer	Ver:IPSim+SG+P1
narguais	narguer	Ver:IImp+SG+P1:IImp+SG+P2
narguait	narguer	Ver:IImp+SG+P3
narguâmes	narguer	Ver:IPSim+PL+P1
nargua	narguer	Ver:IPSim+SG+P3
narguant	narguer	Ver:PPre
narguas	narguer	Ver:IPSim+SG+P2
narguasse	narguer	Ver:SImp+SG+P1
narguassent	narguer	Ver:SImp+PL+P3
narguasses	narguer	Ver:SImp+SG+P2
narguassiez	narguer	Ver:SImp+PL+P2
narguassions	narguer	Ver:SImp+PL+P1
narguâtes	narguer	Ver:IPSim+PL+P2
narguât	narguer	Ver:SImp+SG+P3
narguée	narguer	Ver:PPas+Fem+SG
narguées	narguer	Ver:PPas+Fem+PL
nargue	narguer	Ver:IPre+SG+P1:IPre+SG+P3:SPre+SG+P1:SPre+SG+P3:ImPre+SG+P2
nargué	narguer	Ver:PPas+Mas+SG
narguent	narguer	Ver:IPre+PL+P3:SPre+PL+P3
nargueraient	narguer	Ver:CPre+PL+P3
narguerai	narguer	Ver:IFut+SG+P1
narguerais	narguer	Ver:CPre+SG+P1:CPre+SG+P2
narguerait	narguer	Ver:CPre+SG+P3
narguera	narguer	Ver:IFut+SG+P3
nargueras	narguer	Ver:IFut+SG+P2
narguèrent	narguer	Ver:IPSim+PL+P3
narguerez	narguer	Ver:IFut+PL+P2
nargueriez	narguer	Ver:CPre+PL+P2
narguerions	narguer	Ver:CPre+PL+P1
narguer	narguer	Ver:Inf
narguerons	narguer	Ver:IFut+PL+P1
nargueront	narguer	Ver:IFut+PL+P3
nargues	narguer	Ver:IPre+SG+P2:SPre+SG+P2
nargués	narguer	Ver:PPas+Mas+PL
narguez	narguer	Ver:IPre+PL+P2:ImPre+PL+P2
narguiez	narguer	Ver:IImp+PL+P2:SPre+PL+P2
narguilé	narguilé	Nom:Mas+SG
narguilés	narguilé	Nom:Mas+PL
narguions	narguer	Ver:IImp+PL+P1:SPre+PL+P1
narguons	narguer	Ver:IPre+PL+P1:ImPre+PL+P1
narine	narine	Nom:Fem+SG
narines	narine	Nom:Fem+PL
narquoisement	narquoisement	Adv
narquoise	narquois	Adj:Fem+SG
narquoises	narquois	Adj:Fem+PL
narquois	narquois	Adj:Mas+InvPL
narquois	narquois	Nom:Mas+SG
narraient	narrer	Ver:IImp+PL+P3
narrai	narrer	Ver:IPSim+SG+P1
narrais	narrer	Ver:IImp+SG+P1:IImp+SG+P2
narrait	narrer	Ver:IImp+SG+P3
narrâmes	narrer	Ver:IPSim+PL+P1
narra	narrer	Ver:IPSim+SG+P3
narrant	narrer	Ver:PPre
narras	narrer	Ver:IPSim+SG+P2
narrasse	narrer	Ver:SImp+SG+P1
narrassent	narrer	Ver:SImp+PL+P3
narrasses	narrer	Ver:SImp+SG+P2
narrassiez	narrer	Ver:SImp+PL+P2
narrassions	narrer	Ver:SImp+PL+P1
narrâtes	narrer	Ver:IPSim+PL+P2
narrateur	narrateur	Nom:Mas+SG
narrateurs	narrateur	Nom:Mas+PL
narratif	narratif	Adj:Mas+SG
narratifs	narratif	Adj:Mas+PL
narration	narration	Nom:Fem+SG
narrations	narration	Nom:Fem+PL
narrative	narratif	Adj:Fem+SG
narratives	narratif	Adj:Fem+PL
narrât	narrer	Ver:SImp+SG+P3
narratrice	narrateur	Nom:Fem+SG
narratrices	narrateur	Nom:Fem+PL
narrée	narrer	Ver:PPas+Fem+SG
narrées	narrer	Ver:PPas+Fem+PL
narré	narré	Nom:Mas+SG
narre	narrer	Ver:IPre+SG+P1:IPre+SG+P3:SPre+SG+P1:SPre+SG+P3:ImPre+SG+P2
narré	narrer	Ver:PPas+Mas+SG
narrent	narrer	Ver:IPre+PL+P3:SPre+PL+P3
narreraient	narrer	Ver:CPre+PL+P3
narrerai	narrer	Ver:IFut+SG+P1
narrerais	narrer	Ver:CPre+SG+P1:CPre+SG+P2
narrerait	narrer	Ver:CPre+SG+P3
narrera	narrer	Ver:IFut+SG+P3
narreras	narrer	Ver:IFut+SG+P2
narrèrent	narrer	Ver:IPSim+PL+P3
narrerez	narrer	Ver:IFut+PL+P2
narreriez	narrer	Ver:CPre+PL+P2
narrerions	narrer	Ver:CPre+PL+P1
narrer	narrer	Ver:Inf
narrerons	narrer	Ver:IFut+PL+P1
narreront	narrer	Ver:IFut+PL+P3
narrés	narré	Nom:Mas+PL
narres	narrer	Ver:IPre+SG+P2:SPre+SG+P2
narrés	narrer	Ver:PPas+Mas+PL
narrez	narrer	Ver:IPre+PL+P2:ImPre+PL+P2
narriez	narrer	Ver:IImp+PL+P2:SPre+PL+P2
narrions	narrer	Ver:IImp+PL+P1:SPre+PL+P1
narrons	narrer	Ver:IPre+PL+P1:ImPre+PL+P1
narthex	narthex	Nom:Mas+InvPL
narval	narval	Nom:Mas+SG
narvals	narval	Nom:Mas+PL
nasale	nasal	Adj:Fem+SG
nasale	nasale	Nom:Fem+SG
nasales	nasal	Adj:Fem+PL
nasales	nasale	Nom:Fem+PL
nasalisant	nasaliser	Ver:PPre
nasalisation	nasalisation	Nom:Fem+SG
nasalisations	nasalisation	Nom:Fem+PL
nasalise	nasaliser	Ver:Imp+SG+P2
nasalise	nasaliser	Ver:IPre+SG+P1
nasalise	nasaliser	Ver:IPre+SG+P3
nasalisé	nasaliser	Ver:PPas+Mas+SG
nasalise	nasaliser	Ver:SPre+SG+P1
nasalise	nasaliser	Ver:SPre+SG+P3
nasaliser	nasaliser	Ver:Inf
nasalité	nasalité	Nom:Fem+SG
nasal	nasal	Adj:Mas+SG
nasarde	nasard	Adj:Fem+SG
nasarde	nasarde	Nom:Fem+SG
nasarde	nasarder	Ver:IPre+SG+P1:IPre+SG+P3:SPre+SG+P1:SPre+SG+P3:ImPre+SG+P2
nasardes	nasard	Adj:Fem+PL
nasardes	nasarde	Nom:Fem+PL
nasardes	nasarder	Ver:IPre+SG+P2:SPre+SG+P2
nasard	nasard	Adj:Mas+SG
nasard	nasard	Nom:Mas+SG
nasaux	nasal	Adj:Mas+PL
naseau	naseau	Nom:Mas+SG
naseaux	naseau	Nom:Mas+PL
nase	nase	Adj:InvGen+SG
nase	nase	Nom:Mas+SG
nasillant	nasiller	Ver:PPre
nasillarde	nasillard	Adj:Fem+SG
nasillarde	nasillarder	Ver:IPre+SG+P1:IPre+SG+P3:SPre+SG+P1:SPre+SG+P3:ImPre+SG+P2
nasillardes	nasillard	Adj:Fem+PL
nasillardes	nasillarder	Ver:IPre+SG+P2:SPre+SG+P2
nasillard	nasillard	Adj:Mas+SG
nasillards	nasillard	Adj:Mas+PL
nasillement	nasillement	Nom:Mas+SG
nasillements	nasillement	Nom:Mas+PL
nasillé	nasiller	Ver:PPas+Mas+SG
nasiller	nasiller	Ver:Inf
nasilleur	nasilleur	Nom:Mas+SG
nasilleuse	nasilleur	Nom:Fem+SG
nasique	nasique	Nom:Fem+SG
nasique	nasique	Nom:Mas+SG
nasiques	nasique	Nom:Fem+PL
nasiques	nasique	Nom:Mas+PL
nasitort	nasitort	Nom:Mas+SG
nasonnement	nasonnement	Nom:Mas+SG
nasse	nasse	Nom:Fem+SG
nassérien	nassérien	Adj:Mas+SG
nasses	nasse	Nom:Fem+PL
nastie	nastie	Nom:Fem+SG
natale	natal	Adj:Fem+SG
natales	natal	Adj:Fem+PL
nataliste	nataliste	Adj:InvGen+SG
natalistes	nataliste	Adj:InvGen+PL
natalité	natalité	Nom:Fem+SG
natal	natal	Adj:Mas+SG
natals	natal	Adj:Mas+PL
natation	natation	Nom:Fem+SG
natatoire	natatoire	Adj:InvGen+SG
natatoires	natatoire	Adj:InvGen+PL
natice	natice	Nom:Fem+SG
natif	natif	Adj:Mas+SG
natifs	natif	Adj:Mas+PL
natifs	natif	Nom:Mas+PL
nationale	nationale	Nom:Fem+SG
nationales	nationale	Nom:Fem+PL
nationalisaient	nationaliser	Ver:IImp+PL+P3
nationalisai	nationaliser	Ver:IPSim+SG+P1
nationalisais	nationaliser	Ver:IImp+SG+P1:IImp+SG+P2
nationalisait	nationaliser	Ver:IImp+SG+P3
nationalisâmes	nationaliser	Ver:IPSim+PL+P1
nationalisa	nationaliser	Ver:IPSim+SG+P3
nationalisant	nationaliser	Ver:PPre
nationalisas	nationaliser	Ver:IPSim+SG+P2
nationalisasse	nationaliser	Ver:SImp+SG+P1
nationalisassent	nationaliser	Ver:SImp+PL+P3
nationalisasses	nationaliser	Ver:SImp+SG+P2
nationalisassiez	nationaliser	Ver:SImp+PL+P2
nationalisassions	nationaliser	Ver:SImp+PL+P1
nationalisâtes	nationaliser	Ver:IPSim+PL+P2
nationalisation	nationalisation	Nom:Fem+SG
nationalisations	nationalisation	Nom:Fem+PL
nationalisât	nationaliser	Ver:SImp+SG+P3
nationalisée	nationaliser	Ver:PPas+Fem+SG
nationalisées	nationaliser	Ver:PPas+Fem+PL
nationalise	nationaliser	Ver:IPre+SG+P1:IPre+SG+P3:SPre+SG+P1:SPre+SG+P3:ImPre+SG+P2
nationalisé	nationaliser	Ver:PPas+Mas+SG
nationalisent	nationaliser	Ver:IPre+PL+P3:SPre+PL+P3
nationaliseraient	nationaliser	Ver:CPre+PL+P3
nationaliserai	nationaliser	Ver:IFut+SG+P1
nationaliserais	nationaliser	Ver:CPre+SG+P1
nationaliserais	nationaliser	Ver:CPre+SG+P2
nationaliserait	nationaliser	Ver:CPre+SG+P3
nationalisera	nationaliser	Ver:IFut+SG+P3
nationaliseras	nationaliser	Ver:IFut+SG+P2
nationalisèrent	nationaliser	Ver:IPSim+PL+P3
nationaliserez	nationaliser	Ver:IFut+PL+P2
nationaliseriez	nationaliser	Ver:CPre+PL+P2
nationaliserions	nationaliser	Ver:CPre+PL+P1
nationaliser	nationaliser	Ver:Inf
nationaliserons	nationaliser	Ver:IFut+PL+P1
nationaliseront	nationaliser	Ver:IFut+PL+P3
nationalises	nationaliser	Ver:IPre+SG+P2:SPre+SG+P2
nationalisés	nationaliser	Ver:PPas+Mas+PL
nationalisez	nationaliser	Ver:IPre+PL+P2:ImPre+PL+P2
nationalisiez	nationaliser	Ver:IImp+PL+P2:SPre+PL+P2
nationalisions	nationaliser	Ver:IImp+PL+P1:SPre+PL+P1
nationalisme	nationalisme	Nom:Mas+SG
nationalismes	nationalisme	Nom:Mas+PL
nationalisons	nationaliser	Ver:IPre+PL+P1:ImPre+PL+P1
nationaliste	nationaliste	Adj:InvGen+SG
nationaliste	nationaliste	Nom:InvGen+SG
nationalistes	nationaliste	Adj:InvGen+PL
nationalistes	nationaliste	Nom:InvGen+PL
nationalité	nationalité	Nom:Fem+SG
nationalités	nationalité	Nom:Fem+PL
national	national	Adj:Mas+SG
national-socialisme	national-socialisme	Nom:Mas+SG
national-socialismes	national-socialisme	Nom:Mas+PL
national-socialiste	national-socialiste	Adj:InvGen+SG
national-socialiste	national-socialiste	Nom:InvGen+SG
national-socialiste	national-socialiste	Nom:Mas+SG
nationaux	national	Adj:Mas+PL
nationaux	nationaux	Nom:Mas+PL
nationaux-socialistes	national-socialiste	Nom:Mas+PL
nation	nation	Nom:Fem+SG
nations	nation	Nom:Fem+PL
nativement	nativement	Adv
native	natif	Adj:Fem+SG
native	natif	Nom:Fem+SG
natives	natif	Adj:Fem+PL
natives	natif	Nom:Fem+PL
nativisme	nativisme	Nom:Mas+SG
nativiste	nativiste	Adj:InvGen+SG
nativité	nativité	Nom:Fem+SG
natrémie	natrémie	Nom:Fem+SG
natrium	natrium	Nom:Mas+SG
natron	natron	Nom:Mas+SG
natrum	natrum	Nom:Mas+SG
nattage	nattage	Nom:Mas+SG
nattages	nattage	Nom:Mas+PL
nattaient	natter	Ver:IImp+PL+P3
nattai	natter	Ver:IPSim+SG+P1
nattais	natter	Ver:IImp+SG+P1:IImp+SG+P2
nattait	natter	Ver:IImp+SG+P3
nattâmes	natter	Ver:IPSim+PL+P1
natta	natter	Ver:IPSim+SG+P3
nattant	natter	Ver:PPre
nattas	natter	Ver:IPSim+SG+P2
nattasse	natter	Ver:SImp+SG+P1
nattassent	natter	Ver:SImp+PL+P3
nattasses	natter	Ver:SImp+SG+P2
nattassiez	natter	Ver:SImp+PL+P2
nattassions	natter	Ver:SImp+PL+P1
nattâtes	natter	Ver:IPSim+PL+P2
nattât	natter	Ver:SImp+SG+P3
nattée	natter	Ver:PPas+Fem+SG
natté	natté	Adj:Mas+SG
natte	natte	Nom:Fem+SG
natté	natté	Nom:Mas+SG
natte	natter	Ver:IPre+SG+P1:IPre+SG+P3:SPre+SG+P1:SPre+SG+P3:ImPre+SG+P2
natté	natter	Ver:PPas+Mas+SG
nattent	natter	Ver:IPre+PL+P3:SPre+PL+P3
natteraient	natter	Ver:CPre+PL+P3
natterai	natter	Ver:IFut+SG+P1
natterais	natter	Ver:CPre+SG+P1:CPre+SG+P2
natterait	natter	Ver:CPre+SG+P3
nattera	natter	Ver:IFut+SG+P3
natteras	natter	Ver:IFut+SG+P2
nattèrent	natter	Ver:IPSim+PL+P3
natterez	natter	Ver:IFut+PL+P2
natteriez	natter	Ver:CPre+PL+P2
natterions	natter	Ver:CPre+PL+P1
natter	natter	Ver:Inf
natterons	natter	Ver:IFut+PL+P1
natteront	natter	Ver:IFut+PL+P3
nattes	natte	Nom:Fem+PL
nattes	natter	Ver:IPre+SG+P2:SPre+SG+P2
nattez	natter	Ver:IPre+PL+P2:ImPre+PL+P2
nattière	nattier	Nom:Fem+SG
nattières	nattier	Nom:Fem+PL
nattier	nattier	Adj:InvGen+SG:InvGen+PL
nattier	nattier	Nom:Mas+SG
nattiers	nattier	Nom:Mas+PL
nattiez	natter	Ver:IImp+PL+P2:SPre+PL+P2
nattions	natter	Ver:IImp+PL+P1:SPre+PL+P1
nattons	natter	Ver:IPre+PL+P1:ImPre+PL+P1
naturalisant	naturaliser	Ver:PPre
naturalisation	naturalisation	Nom:Fem+SG
naturalisations	naturalisation	Nom:Fem+PL
naturalisée	naturalisé	Adj:Fem+SG
naturalisée	naturalisé	Nom:Fem+SG
naturalisée	naturaliser	Ver:PPas+Fem+SG
naturalisées	naturalisé	Adj:Fem+PL
naturalisées	naturalisé	Nom:Fem+PL
naturalisées	naturaliser	Ver:PPas+Fem+PL
naturalisé	naturalisé	Adj:Mas+SG
naturaliser	naturaliser	Ver:Inf
naturalisés	naturalisé	Adj:Mas+PL
naturalisés	naturalisé	Nom:Mas+PL
naturalisés	naturaliser	Ver:PPas+Mas+PL
naturalisme	naturalisme	Nom:Mas+SG
naturaliste	naturaliste	Adj:InvGen+SG
naturalistes	naturaliste	Adj:InvGen+PL
naturellement	naturellement	Adv
naturelle	naturel	Adj:Fem+SG
naturelle	naturel	Nom:Fem+SG
naturelles	naturel	Adj:Fem+PL
naturelles	naturel	Nom:Fem+PL
naturel	naturel	Adj:Mas+SG
naturel	naturel	Nom:Mas+SG
naturels	naturel	Adj:Mas+PL
naturels	naturel	Nom:Mas+PL
nature	nature	Adj:InvGen+SG:InvGen+PL
nature	nature	Adv
nature	nature	Nom:Fem+SG
natures	nature	Nom:Fem+PL
natures	natures	Nom:Fem+PL
naturisme	naturisme	Nom:Mas+SG
naturiste	naturiste	Adj:InvGen+SG
naturistes	naturiste	Adj:InvGen+PL
naucore	naucore	Nom:Fem+SG
naufrageant	naufrager	Ver:PPre
naufragée	naufragé	Adj:Fem+SG
naufragées	naufragé	Adj:Fem+PL
naufragé	naufragé	Adj:Mas+SG
naufrage	naufrage	Nom:Mas+SG
naufrage	naufrager	Ver:IPre+SG+P1:IPre+SG+P3:SPre+SG+P1:SPre+SG+P3:ImPre+SG+P2
naufragent	naufrager	Ver:IPre+PL+P3:SPre+PL+P3
naufrager	naufrager	Ver:Inf
naufragés	naufragé	Adj:Mas+PL
naufrages	naufrage	Nom:Mas+PL
naufrages	naufrager	Ver:IPre+SG+P2:SPre+SG+P2
naufrageur	naufrageur	Nom:Mas+SG
naufrageurs	naufrageur	Nom:Mas+PL
naufrageuse	naufrageur	Nom:Fem+SG
naumachie	naumachie	Nom:Fem+SG
naupathie	naupathie	Nom:Fem+SG
nauplius	nauplius	Nom:Mas+InvPL
nauséabonde	nauséabond	Adj:Fem+SG
nauséabondes	nauséabond	Adj:Fem+PL
nauséabond	nauséabond	Adj:Mas+SG
nauséabonds	nauséabond	Adj:Mas+PL
nausée	nausée	Nom:Fem+SG
nausées	nausée	Nom:Fem+PL
nauséeuse	nauséeux	Adj:Fem+SG
nauséeuses	nauséeux	Adj:Fem+PL
nauséeux	nauséeux	Adj:Mas+InvPL
nautile	nautile	Nom:Mas+SG
nautiles	nautile	Nom:Mas+PL
nautique	nautique	Adj:InvGen+SG
nautiques	nautique	Adj:InvGen+PL
nautisme	nautisme	Nom:Mas+SG
nautonière	nautonier	Nom:Fem+SG
nautonier	nautonier	Nom:Mas+SG
navaja	navaja	Nom:Fem+SG
navale	naval	Adj:Fem+SG
navale	navale	Nom:Fem+SG
navales	naval	Adj:Fem+PL
navalisation	navalisation	Nom:Fem+SG
naval	naval	Adj:Mas+SG
navals	naval	Adj:Mas+PL
navarin	navarin	Nom:Mas+SG
navarins	navarin	Nom:Mas+PL
navarque	navarque	Nom:Mas+SG
navarraise	navarrais	Adj:Fem+SG
navarraise	navarrais	Nom:Fem+SG
navarrais	navarrais	Adj:Mas+InvPL
navarrais	navarrais	Nom:Mas+InvPL
navel	navel	Nom:Fem+SG
navet	navet	Nom:Mas+SG
navets	navet	Nom:Mas+PL
navette	navette	Nom:Fem+SG
navettes	navette	Nom:Fem+PL
navetteur	navetteur	Nom:Mas+SG
navicert	navicert	Nom:Mas+InvPL
naviculaire	naviculaire	Adj:InvGen+SG
navicule	navicule	Nom:Fem+SG
navigabilité	navigabilité	Nom:Fem+SG
navigable	navigable	Adj:InvGen+SG
navigables	navigable	Adj:InvGen+PL
navigante	navigant	Adj:Fem+SG
navigantes	navigant	Adj:Fem+PL
navigantes	navigant	Nom:Fem+PL
navigant	navigant	Adj:Mas+SG
navigant	navigant	Nom:Mas+SG
navigants	navigant	Adj:Mas+PL
navigants	navigant	Nom:Mas+PL
navigateur	navigateur	Adj:Mas+SG
navigateurs	navigateur	Adj:Mas+PL
navigation	navigation	Nom:Fem+SG
navigations	navigation	Nom:Fem+PL
naviguaient	naviguer	Ver:IImp+PL+P3
naviguai	naviguer	Ver:IPSim+SG+P1
naviguais	naviguer	Ver:IImp+SG+P1:IImp+SG+P2
naviguait	naviguer	Ver:IImp+SG+P3
naviguâmes	naviguer	Ver:IPSim+PL+P1
navigua	naviguer	Ver:IPSim+SG+P3
naviguant	naviguer	Ver:PPre
naviguas	naviguer	Ver:IPSim+SG+P2
naviguasse	naviguer	Ver:SImp+SG+P1
naviguassent	naviguer	Ver:SImp+PL+P3
naviguasses	naviguer	Ver:SImp+SG+P2
naviguassiez	naviguer	Ver:SImp+PL+P2
naviguassions	naviguer	Ver:SImp+PL+P1
naviguâtes	naviguer	Ver:IPSim+PL+P2
naviguât	naviguer	Ver:SImp+SG+P3
navigue	naviguer	Ver:IPre+SG+P1:IPre+SG+P3:SPre+SG+P1:SPre+SG+P3:ImPre+SG+P2
navigué	naviguer	Ver:PPas+Mas+SG
naviguent	naviguer	Ver:IPre+PL+P3:SPre+PL+P3
navigueraient	naviguer	Ver:CPre+PL+P3
naviguerai	naviguer	Ver:IFut+SG+P1
naviguerais	naviguer	Ver:CPre+SG+P1:CPre+SG+P2
naviguerait	naviguer	Ver:CPre+SG+P3
naviguera	naviguer	Ver:IFut+SG+P3
navigueras	naviguer	Ver:IFut+SG+P2
naviguèrent	naviguer	Ver:IPSim+PL+P3
naviguerez	naviguer	Ver:IFut+PL+P2
navigueriez	naviguer	Ver:CPre+PL+P2
naviguerions	naviguer	Ver:CPre+PL+P1
naviguer	naviguer	Ver:Inf
naviguerons	naviguer	Ver:IFut+PL+P1
navigueront	naviguer	Ver:IFut+PL+P3
navigues	naviguer	Ver:IPre+SG+P2:SPre+SG+P2
naviguez	naviguer	Ver:IPre+PL+P2:ImPre+PL+P2
naviguiez	naviguer	Ver:IImp+PL+P2:SPre+PL+P2
naviguions	naviguer	Ver:IImp+PL+P1:SPre+PL+P1
naviguons	naviguer	Ver:IPre+PL+P1:ImPre+PL+P1
naviplane	naviplane	Nom:Mas+SG
navire	navire	Nom:Mas+SG
navires	navire	Nom:Mas+PL
navires-citernes	navire-citerne	Nom:Mas+PL
navires-écoles	navire-école	Nom:Mas+PL
navires-jumeaux	navire-jumeau	Nom:Mas+PL
navire-citerne	navire-citerne	Nom:Mas+SG
navire-école	navire-école	Nom:Mas+SG
navire-jumeau	navire-jumeau	Nom:Mas+SG
navisphère	navisphère	Nom:Fem+SG
navraient	navrer	Ver:IImp+PL+P3
navrai	navrer	Ver:IPSim+SG+P1
navrais	navrer	Ver:IImp+SG+P1:IImp+SG+P2
navrait	navrer	Ver:IImp+SG+P3
navrâmes	navrer	Ver:IPSim+PL+P1
navra	navrer	Ver:IPSim+SG+P3
navrante	navrant	Adj:Fem+SG
navrantes	navrant	Adj:Fem+PL
navrant	navrant	Adj:Mas+SG
navrant	navrer	Ver:PPre
navrants	navrant	Adj:Mas+PL
navras	navrer	Ver:IPSim+SG+P2
navrasse	navrer	Ver:SImp+SG+P1
navrassent	navrer	Ver:SImp+PL+P3
navrasses	navrer	Ver:SImp+SG+P2
navrassiez	navrer	Ver:SImp+PL+P2
navrassions	navrer	Ver:SImp+PL+P1
navrâtes	navrer	Ver:IPSim+PL+P2
navrât	navrer	Ver:SImp+SG+P3
navrée	navrer	Ver:PPas+Fem+SG
navrées	navrer	Ver:PPas+Fem+PL
navrement	navrement	Nom:Mas+SG
navre	navrer	Ver:IPre+SG+P1:IPre+SG+P3:SPre+SG+P1:SPre+SG+P3:ImPre+SG+P2
navré	navrer	Ver:PPas+Mas+SG
navrent	navrer	Ver:IPre+PL+P3:SPre+PL+P3
navreraient	navrer	Ver:CPre+PL+P3
navrerai	navrer	Ver:IFut+SG+P1
navrerais	navrer	Ver:CPre+SG+P1:CPre+SG+P2
navrerait	navrer	Ver:CPre+SG+P3
navrera	navrer	Ver:IFut+SG+P3
navreras	navrer	Ver:IFut+SG+P2
navrèrent	navrer	Ver:IPSim+PL+P3
navrerez	navrer	Ver:IFut+PL+P2
navreriez	navrer	Ver:CPre+PL+P2
navrerions	navrer	Ver:CPre+PL+P1
navrer	navrer	Ver:Inf
navrerons	navrer	Ver:IFut+PL+P1
navreront	navrer	Ver:IFut+PL+P3
navres	navrer	Ver:IPre+SG+P2:SPre+SG+P2
navrés	navrer	Ver:PPas+Mas+PL
navrez	navrer	Ver:IPre+PL+P2:ImPre+PL+P2
navriez	navrer	Ver:IImp+PL+P2:SPre+PL+P2
navrions	navrer	Ver:IImp+PL+P1:SPre+PL+P1
navrons	navrer	Ver:IPre+PL+P1:ImPre+PL+P1
nazaréen	nazaréen	Adj:Mas+SG
nazaréen	nazaréen	Nom:Mas+SG
nazaréenne	nazaréen	Adj:Fem+SG
nazaréenne	nazaréen	Nom:Fem+SG
nazaréennes	nazaréen	Adj:Fem+PL
nazaréennes	nazaréen	Nom:Fem+PL
nazaréens	nazaréen	Adj:Mas+PL
naze	naze	Adj:InvGen+SG
nazie	nazi	Adj:Fem+SG
nazie	nazi	Nom:Fem+SG
nazies	nazi	Adj:Fem+PL
nazies	nazi	Nom:Fem+PL
nazi	nazi	Adj:Mas+SG
nazisme	nazisme	Nom:Mas+SG
nazis	nazi	Adj:Mas+PL
nazis	nazi	Nom:Mas+PL
néandertalien	néandertalien	Adj:Mas+SG
néandertalienne	néandertalien	Adj:Fem+SG
néandertaliennes	néandertalien	Adj:Fem+PL
néandertaliens	néandertalien	Adj:Mas+PL
néanmoins	néanmoins	Adv
néanthropien	néanthropien	Adj:Mas+SG
néantisation	néantisation	Nom:Fem+SG
néantisations	néantisation	Nom:Fem+PL
néantiser	néantiser	Ver:Inf
néant	néant	Nom:Mas+SG
néants	néant	Nom:Mas+PL
nebka	nebka	Nom:Fem+SG
nébuleuse	nébuleuse	Nom:Fem+SG
nébuleuse	nébuleux	Adj:Fem+SG
nébuleuses	nébuleuse	Nom:Fem+PL
nébuleuses	nébuleux	Adj:Fem+PL
nébuleux	nébuleux	Adj:Mas+InvPL
nébulisation	nébulisation	Nom:Fem+SG
nébulisations	nébulisation	Nom:Fem+PL
nébuliser	nébuliser	Ver:Inf
nébuliseur	nébuliseur	Nom:Mas+SG
nébulosité	nébulosité	Nom:Fem+SG
nécessairement	nécessairement	Adv
nécessaire	nécessaire	Adj:InvGen+SG
nécessaire	nécessaire	Nom:Mas+SG
nécessaires	nécessaire	Adj:InvGen+PL
nécessaires	nécessaire	Nom:Mas+PL
nécessitaient	nécessiter	Ver:IImp+PL+P3
nécessitai	nécessiter	Ver:IPSim+SG+P1
nécessitais	nécessiter	Ver:IImp+SG+P1:IImp+SG+P2
nécessitait	nécessiter	Ver:IImp+SG+P3
nécessitâmes	nécessiter	Ver:IPSim+PL+P1
nécessita	nécessiter	Ver:IPSim+SG+P3
nécessitante	nécessitant	Adj:Fem+SG
nécessitantes	nécessitant	Adj:Fem+PL
nécessitant	nécessitant	Adj:Mas+SG
nécessitant	nécessiter	Ver:PPre
nécessitas	nécessiter	Ver:IPSim+SG+P2
nécessitasse	nécessiter	Ver:SImp+SG+P1
nécessitassent	nécessiter	Ver:SImp+PL+P3
nécessitasses	nécessiter	Ver:SImp+SG+P2
nécessitassiez	nécessiter	Ver:SImp+PL+P2
nécessitassions	nécessiter	Ver:SImp+PL+P1
nécessitâtes	nécessiter	Ver:IPSim+PL+P2
nécessitât	nécessiter	Ver:SImp+SG+P3
nécessitée	nécessiter	Ver:PPas+Fem+SG
nécessitées	nécessiter	Ver:PPas+Fem+PL
nécessité	nécessité	Nom:Fem+SG
nécessite	nécessiter	Ver:Imp+SG+P2
nécessite	nécessiter	Ver:IPre+SG+P1
nécessite	nécessiter	Ver:IPre+SG+P3
nécessité	nécessiter	Ver:PPas+Mas+SG
nécessite	nécessiter	Ver:SPre+SG+P1
nécessite	nécessiter	Ver:SPre+SG+P3
nécessitent	nécessiter	Ver:IPre+PL+P3:SPre+PL+P3
nécessiteraient	nécessiter	Ver:CPre+PL+P3
nécessiterai	nécessiter	Ver:IFut+SG+P1
nécessiterais	nécessiter	Ver:CPre+SG+P1:CPre+SG+P2
nécessiterait	nécessiter	Ver:CPre+SG+P3
nécessitera	nécessiter	Ver:IFut+SG+P3
nécessiteras	nécessiter	Ver:IFut+SG+P2
nécessitèrent	nécessiter	Ver:IPSim+PL+P3
nécessiterez	nécessiter	Ver:IFut+PL+P2
nécessiteriez	nécessiter	Ver:CPre+PL+P2
nécessiterions	nécessiter	Ver:CPre+PL+P1
nécessiter	nécessiter	Ver:Inf
nécessiterons	nécessiter	Ver:IFut+PL+P1
nécessiteront	nécessiter	Ver:IFut+PL+P3
nécessités	nécessité	Nom:Fem+PL
nécessites	nécessiter	Ver:IPre+SG+P2
nécessités	nécessiter	Ver:PPas+Mas+PL
nécessites	nécessiter	Ver:SPre+SG+P2
nécessiteuse	nécessiteux	Adj:Fem+SG
nécessiteuse	nécessiteux	Nom:Fem+SG
nécessiteuses	nécessiteux	Adj:Fem+PL
nécessiteuses	nécessiteux	Nom:Fem+PL
nécessiteux	nécessiteux	Adj:Mas+InvPL
nécessiteux	nécessiteux	Nom:Mas+InvPL
nécessitez	nécessiter	Ver:IPre+PL+P2:ImPre+PL+P2
nécessitiez	nécessiter	Ver:IImp+PL+P2:SPre+PL+P2
nécessitions	nécessiter	Ver:IImp+PL+P1:SPre+PL+P1
nécessitons	nécessiter	Ver:IPre+PL+P1:ImPre+PL+P1
neck	neck	Nom:Mas+SG
nécrobie	nécrobie	Nom:Fem+SG
nécrologe	nécrologe	Nom:Mas+SG
nécrologie	nécrologie	Nom:Fem+SG
nécrologies	nécrologie	Nom:Fem+PL
nécrologique	nécrologique	Adj:InvGen+SG
nécrologiques	nécrologique	Adj:InvGen+PL
nécrologue	nécrologue	Nom:InvGen+SG
nécromancie	nécromancie	Nom:Fem+SG
nécromancien	nécromancien	Nom:Mas+SG
nécromancienne	nécromancien	Nom:Fem+SG
nécromanciennes	nécromancien	Nom:Fem+PL
nécromant	nécromant	Nom:Mas+SG
nécrophage	nécrophage	Adj:InvGen+SG
nécrophile	nécrophile	Adj:InvGen+SG
nécrophile	nécrophile	Nom:InvGen+SG
nécrophilie	nécrophilie	Nom:Fem+SG
nécrophore	nécrophore	Nom:Mas+SG
nécropole	nécropole	Nom:Fem+SG
nécropoles	nécropole	Nom:Fem+PL
nécropsie	nécropsie	Nom:Fem+SG
nécrosaient	nécroser	Ver:IImp+PL+P3
nécrosai	nécroser	Ver:IPSim+SG+P1
nécrosais	nécroser	Ver:IImp+SG+P1:IImp+SG+P2
nécrosait	nécroser	Ver:IImp+SG+P3
nécrosâmes	nécroser	Ver:IPSim+PL+P1
nécrosa	nécroser	Ver:IPSim+SG+P3
nécrosant	nécrosant	Adj:Mas+SG
nécrosas	nécroser	Ver:IPSim+SG+P2
nécrosasse	nécroser	Ver:SImp+SG+P1
nécrosassent	nécroser	Ver:SImp+PL+P3
nécrosasses	nécroser	Ver:SImp+SG+P2
nécrosassiez	nécroser	Ver:SImp+PL+P2
nécrosassions	nécroser	Ver:SImp+PL+P1
nécrosâtes	nécroser	Ver:IPSim+PL+P2
nécrosât	nécroser	Ver:SImp+SG+P3
nécrosée	nécroser	Ver:PPas+Fem+SG
nécrosées	nécroser	Ver:PPas+Fem+PL
nécrose	nécrose	Nom:Fem+SG
nécrose	nécroser	Ver:IPre+SG+P1:IPre+SG+P3:SPre+SG+P1:SPre+SG+P3:ImPre+SG+P2
nécrosé	nécroser	Ver:PPas+Mas+SG
nécrosent	nécroser	Ver:IPre+PL+P3:SPre+PL+P3
nécroseraient	nécroser	Ver:CPre+PL+P3
nécroserai	nécroser	Ver:IFut+SG+P1
nécroserais	nécroser	Ver:CPre+SG+P1:CPre+SG+P2
nécroserait	nécroser	Ver:CPre+SG+P3
nécrosera	nécroser	Ver:IFut+SG+P3
nécroseras	nécroser	Ver:IFut+SG+P2
nécrosèrent	nécroser	Ver:IPSim+PL+P3
nécroserez	nécroser	Ver:IFut+PL+P2
nécroseriez	nécroser	Ver:CPre+PL+P2
nécroserions	nécroser	Ver:CPre+PL+P1
nécroser	nécroser	Ver:Inf
nécroserons	nécroser	Ver:IFut+PL+P1
nécroseront	nécroser	Ver:IFut+PL+P3
nécroses	nécrose	Nom:Fem+PL
nécroses	nécroser	Ver:IPre+SG+P2:SPre+SG+P2
nécrosés	nécroser	Ver:PPas+Mas+PL
nécrosez	nécroser	Ver:IPre+PL+P2:ImPre+PL+P2
nécrosiez	nécroser	Ver:IImp+PL+P2:SPre+PL+P2
nécrosions	nécroser	Ver:IImp+PL+P1:SPre+PL+P1
nécrosons	nécroser	Ver:IPre+PL+P1:ImPre+PL+P1
nécrotique	nécrotique	Adj:InvGen+SG
nectaire	nectaire	Nom:Mas+SG
nectarifère	nectarifère	Adj:InvGen+SG
nectarine	nectarine	Nom:Fem+SG
nectarines	nectarine	Nom:Fem+PL
nectar	nectar	Nom:Mas+SG
nectars	nectar	Nom:Mas+PL
necton	necton	Nom:Mas+SG
nec-plus-ultra	nec-plus-ultra	Nom:Mas+InvPL
née	naître	Ver:PPas+Fem+SG
née	né	Adj:Fem+SG
née	né	Nom:Fem+SG
néerlandaise	néerlandais	Adj:Fem+SG
néerlandaise	néerlandais	Nom:Fem+SG
néerlandaises	néerlandais	Adj:Fem+PL
néerlandaises	néerlandais	Nom:Fem+PL
néerlandais	néerlandais	Adj:Mas+InvPL
néerlandais	néerlandais	Nom:Mas+InvPL
néerlandais	néerlandais	Nom:Mas+SG
nées	naître	Ver:PPas+Fem+PL
nées	né	Adj:Fem+PL
nées	né	Nom:Fem+PL
néfaste	néfaste	Adj:InvGen+SG
néfastes	néfaste	Adj:InvGen+PL
nèfle	nèfle	Nom:Fem+SG
nèfles	nèfle	Nom:Fem+PL
néflier	néflier	Nom:Mas+SG
nef	nef	Nom:Fem+SG
nefs	nef	Nom:Fem+PL
négateur	négateur	Adj:Mas+SG
négateur	négateur	Nom:Mas+SG
négatif	négatif	Adj:Mas+SG
négatif	négatif	Adv
négatif	négatif	Nom:Mas+SG
négatifs	négatif	Adj:Mas+PL
négatifs	négatif	Nom:Mas+PL
négation	négation	Nom:Fem+SG
négations	négation	Nom:Fem+PL
négativement	négativement	Adv
négative	négatif	Adj:Fem+SG
négative	négative	Nom:Fem+SG
négative	négativer	Ver:IPre+SG+P1:IPre+SG+P3:SPre+SG+P1:SPre+SG+P3:ImPre+SG+P2
négatives	négatif	Adj:Fem+PL
négaton	négaton	Nom:Mas+SG
négatoscope	négatoscope	Nom:Mas+SG
négatrice	négateur	Adj:Fem+SG
négatrice	négateur	Nom:Fem+SG
négentropie	négentropie	Nom:Fem+SG
négligeable	négligeable	Adj:InvGen+SG
négligeables	négligeable	Adj:InvGen+PL
négligeaient	négliger	Ver:IImp+PL+P3
négligeai	négliger	Ver:IPSim+SG+P1
négligeais	négliger	Ver:IImp+SG+P1:IImp+SG+P2
négligeait	négliger	Ver:IImp+SG+P3
négligeâmes	négliger	Ver:IPSim+PL+P1
négligea	négliger	Ver:IPSim+SG+P3
négligeant	négliger	Ver:PPre
négligeas	négliger	Ver:IPSim+SG+P2
négligeasse	négliger	Ver:SImp+SG+P1
négligeassent	négliger	Ver:SImp+PL+P3
négligeasses	négliger	Ver:SImp+SG+P2
négligeassiez	négliger	Ver:SImp+PL+P2
négligeassions	négliger	Ver:SImp+PL+P1
négligeâtes	négliger	Ver:IPSim+PL+P2
négligeât	négliger	Ver:SImp+SG+P3
négligée	négligé	Adj:Fem+SG
négligée	négliger	Ver:PPas+Fem+SG
négligées	négligé	Adj:Fem+PL
négligées	négliger	Ver:PPas+Fem+PL
négligemment	négligemment	Adv
négligence	négligence	Nom:Fem+SG
négligences	négligence	Nom:Fem+PL
négligé	négligé	Adj:Mas+SG
négligé	négligé	Nom:Mas+SG
néglige	négliger	Ver:IPre+SG+P1:IPre+SG+P3:SPre+SG+P1:SPre+SG+P3:ImPre+SG+P2
négligé	négliger	Ver:PPas+Mas+SG
négligente	négligent	Adj:Fem+SG
négligente	négligent	Nom:Fem+SG
négligentes	négligent	Adj:Fem+PL
négligentes	négligent	Nom:Fem+PL
négligent	négligent	Adj:Mas+SG
négligent	négligent	Nom:Mas+SG
négligent	négliger	Ver:IPre+PL+P3:SPre+PL+P3
négligents	négligent	Adj:Mas+PL
négligents	négligent	Nom:Mas+PL
négligeons	négliger	Ver:IPre+PL+P1:ImPre+PL+P1
négligeraient	négliger	Ver:CPre+PL+P3
négligerai	négliger	Ver:IFut+SG+P1
négligerais	négliger	Ver:CPre+SG+P1:CPre+SG+P2
négligerait	négliger	Ver:CPre+SG+P3
négligera	négliger	Ver:IFut+SG+P3
négligeras	négliger	Ver:IFut+SG+P2
négligèrent	négliger	Ver:IPSim+PL+P3
négligerez	négliger	Ver:IFut+PL+P2
négligeriez	négliger	Ver:CPre+PL+P2
négligerions	négliger	Ver:CPre+PL+P1
négliger	négliger	Ver:Inf
négligerons	négliger	Ver:IFut+PL+P1
négligeront	négliger	Ver:IFut+PL+P3
négligés	négligé	Adj:Mas+PL
négligés	négligé	Nom:Mas+PL
négliges	négliger	Ver:IPre+SG+P2:SPre+SG+P2
négligés	négliger	Ver:PPas+Mas+PL
négligez	négliger	Ver:IPre+PL+P2:ImPre+PL+P2
négligiez	négliger	Ver:IImp+PL+P2:SPre+PL+P2
négligions	négliger	Ver:IImp+PL+P1:SPre+PL+P1
négoce	négoce	Nom:Mas+SG
négoces	négoce	Nom:Mas+PL
négociabilité	négociabilité	Nom:Fem+SG
négociable	négociable	Adj:InvGen+SG
négociables	négociable	Adj:InvGen+PL
négociaient	négocier	Ver:IImp+PL+P3
négociai	négocier	Ver:IPSim+SG+P1
négociais	négocier	Ver:IImp+SG+P1:IImp+SG+P2
négociait	négocier	Ver:IImp+SG+P3
négociâmes	négocier	Ver:IPSim+PL+P1
négocia	négocier	Ver:IPSim+SG+P3
négociante	négociant	Nom:Fem+SG
négociantes	négociant	Nom:Fem+PL
négociant	négociant	Nom:Mas+SG
négociant	négocier	Ver:PPre
négociants	négociant	Nom:Mas+PL
négocias	négocier	Ver:IPSim+SG+P2
négociasse	négocier	Ver:SImp+SG+P1
négociassent	négocier	Ver:SImp+PL+P3
négociasses	négocier	Ver:SImp+SG+P2
négociassiez	négocier	Ver:SImp+PL+P2
négociassions	négocier	Ver:SImp+PL+P1
négociâtes	négocier	Ver:IPSim+PL+P2
négociateur	négociateur	Adj:Mas+SG
négociateur	négociateur	Nom:Mas+SG
négociateurs	négociateur	Adj:Mas+PL
négociation	négociation	Nom:Fem+SG
négociations	négociation	Nom:Fem+PL
négociât	négocier	Ver:SImp+SG+P3
négociatrice	négociateur	Adj:Fem+SG
négociatrice	négociateur	Nom:Fem+SG
négociatrices	négociateur	Adj:Fem+PL
négociatrices	négociateur	Nom:Fem+PL
négociée	négocier	Ver:PPas+Fem+SG
négociées	négocier	Ver:PPas+Fem+PL
négocie	négocier	Ver:IPre+SG+P1:IPre+SG+P3:SPre+SG+P1:SPre+SG+P3:ImPre+SG+P2
négocié	négocier	Ver:PPas+Mas+SG
négocient	négocier	Ver:IPre+PL+P3:SPre+PL+P3
négocieraient	négocier	Ver:CPre+PL+P3
négocierai	négocier	Ver:IFut+SG+P1
négocierais	négocier	Ver:CPre+SG+P1
négocierais	négocier	Ver:CPre+SG+P2
négocierait	négocier	Ver:CPre+SG+P3
négociera	négocier	Ver:IFut+SG+P3
négocieras	négocier	Ver:IFut+SG+P2
négocièrent	négocier	Ver:IPSim+PL+P3
négocierez	négocier	Ver:IFut+PL+P2
négocieriez	négocier	Ver:CPre+PL+P2
négocierions	négocier	Ver:CPre+PL+P1
négocier	négocier	Ver:Inf
négocierons	négocier	Ver:IFut+PL+P1
négocieront	négocier	Ver:IFut+PL+P3
négocies	négocier	Ver:IPre+SG+P2:SPre+SG+P2
négociés	négocier	Ver:PPas+Mas+PL
négociez	négocier	Ver:IPre+PL+P2:ImPre+PL+P2
négociiez	négocier	Ver:IImp+PL+P2:SPre+PL+P2
négociions	négocier	Ver:IImp+PL+P1:SPre+PL+P1
négocions	négocier	Ver:IPre+PL+P1:ImPre+PL+P1
négondo	négondo	Nom:Mas+SG
nègre	nègre	Adj:InvGen+SG
nègre	nègre	Adj:Mas+SG
nègre	nègre	Nom:Mas+SG
nègres	nègre	Adj:InvGen+PL
nègres	nègre	Adj:Mas+PL
nègres	nègre	Nom:Mas+PL
négresse	nègre	Nom:Fem+SG
négresses	nègre	Nom:Fem+PL
négrière	négrier	Adj:Fem+SG
négrière	négrier	Nom:Fem+SG
négrier	négrier	Adj:Mas+SG
négrier	négrier	Nom:Mas+SG
négriers	négrier	Adj:Mas+PL
négriers	négrier	Nom:Mas+PL
négrille	négrille	Nom:Mas+SG
négrillon	négrillon	Nom:Mas+SG
négrillonne	négrillon	Nom:Fem+SG
négrillonnes	négrillon	Nom:Fem+PL
négrillons	négrillon	Nom:Mas+PL
négritude	négritude	Nom:Fem+SG
négritudes	négritude	Nom:Fem+PL
négroïde	négroïde	Adj:InvGen+SG
négroïde	négroïde	Nom:InvGen+SG
négroïdes	négroïde	Adj:InvGen+PL
négroïdes	négroïde	Nom:InvGen+PL
négro	négro	Nom:InvGen+SG
negro-spiritual	negro-spiritual	Nom:Mas+SG
negro-spirituals	negro-spiritual	Nom:Mas+PL
néguentropie	néguentropie	Nom:Fem+SG
négus	négus	Nom:Mas+InvPL
neigeaient	neiger	Ver:IImp+PL+P3
neigeai	neiger	Ver:IPSim+SG+P1
neigeais	neiger	Ver:IImp+SG+P1
neigeais	neiger	Ver:IImp+SG+P2
neigeait	neiger	Ver:IImp+SG+P3
neigeâmes	neiger	Ver:IPSim+PL+P1
neigea	neiger	Ver:IPSim+SG+P3
neigeant	neiger	Ver:PPre
neigeas	neiger	Ver:IPSim+SG+P2
neigeasse	neigeasser	Ver:IPre+SG+P3:SPre+SG+P3
neigeassent	neigeasser	Ver:IPre+PL+P3:SPre+PL+P3
neigeassent	neiger	Ver:SImp+PL+P3
neigeasses	neiger	Ver:SImp+SG+P2
neigeassiez	neiger	Ver:SImp+PL+P2
neigeassions	neiger	Ver:SImp+PL+P1
neigeâtes	neiger	Ver:IPSim+PL+P2
neigeât	neiger	Ver:SImp+SG+P3
neige	neige	Nom:Fem+SG
neige	neiger	Ver:IPre+SG+P3:SPre+SG+P3
neigé	neiger	Ver:PPas+Mas+SG
neigent	neiger	Ver:IPre+PL+P3:SPre+PL+P3
neigeons	neiger	Ver:Imp+PL+P1
neigeons	neiger	Ver:IPre+PL+P1
neigeraient	neiger	Ver:CPre+PL+P3
neigerai	neiger	Ver:IFut+SG+P1
neigerais	neiger	Ver:CPre+SG+P1
neigerais	neiger	Ver:CPre+SG+P2
neigerait	neiger	Ver:CPre+SG+P3
neigera	neiger	Ver:IFut+SG+P3
neigeras	neiger	Ver:IFut+SG+P2
neigèrent	neiger	Ver:IPSim+PL+P3
neigerez	neiger	Ver:IFut+PL+P2
neigeriez	neiger	Ver:CPre+PL+P2
neigerions	neiger	Ver:CPre+PL+P1
neiger	neiger	Ver:Inf
neigerons	neiger	Ver:IFut+PL+P1
neigeront	neiger	Ver:IFut+PL+P3
neiges	neige	Nom:Fem+PL
neigeuse	neigeux	Adj:Fem+SG
neigeuses	neigeux	Adj:Fem+PL
neigeux	neigeux	Adj:Mas+InvPL
neigez	neiger	Ver:Imp+PL+P2
neigez	neiger	Ver:IPre+PL+P2
neigiez	neiger	Ver:IImp+PL+P2
neigiez	neiger	Ver:SPre+PL+P2
neigions	neiger	Ver:IImp+PL+P1
neigions	neiger	Ver:SPre+PL+P1
nélombo	nélombo	Nom:Mas+SG
némale	némale	Nom:Mas+SG
némalion	némalion	Nom:Mas+SG
némathelminthe	némathelminthe	Nom:Mas+SG
nématique	nématique	Adj:InvGen+SG
nématique	nématique	Nom:Mas+SG
nématocyste	nématocyste	Nom:Mas+SG
nématode	nématode	Nom:Mas+SG
nématodes	nématode	Nom:Mas+PL
néméens	néméen	Adj:Mas+PL
némerte	némerte	Nom:Mas+SG
nemrod	nemrod	Nom:Mas+SG
né	naître	Ver:PPas+Mas+SG
né	né	Adj:Mas+SG
néné	néné	Nom:Mas+SG
né	né	Nom:Mas+SG
nénette	nénette	Nom:Fem+SG
nénies	nénies	Nom:Fem+PL
nenni	nenni	Adv
nénuphar	nénuphar	Nom:Mas+SG
nénuphars	nénuphar	Nom:Mas+PL
néoblaste	néoblaste	Nom:Mas+SG
néocapitaliste	néocapitaliste	Adj:InvGen+SG
néoclassique	néoclassique	Adj:InvGen+SG
néocolonialisme	néocolonialisme	Nom:Mas+SG
néocolonialiste	néocolonialiste	Adj:InvGen+SG
néocolonialistes	néocolonialiste	Adj:InvGen+PL
néocomienne	néocomien	Adj:Fem+SG
néocomien	néocomien	Adj:Mas+SG
néocomiennes	néocomien	Adj:Fem+PL
néodarwinisme	néodarwinisme	Nom:Mas+SG
néodyme	néodyme	Nom:Mas+SG
néoformation	néoformation	Nom:Fem+SG
néoformé	néoformé	Adj:Mas+SG
néoformé	néoformer	Ver:PPas+Mas+SG
néogène	néogène	Adj:InvGen+SG
néogothique	néogothique	Adj:InvGen+SG
néogrecque	néogrec	Adj:Fem+SG
néolamarckisme	néolamarckisme	Nom:Mas+SG
néolibéralisme	néolibéralisme	Nom:Mas+SG
néolibéral	néolibéral	Adj:Mas+SG
néolithique	néolithique	Adj:InvGen+SG
néolithiques	néolithique	Adj:InvGen+PL
néolithiques	néolithique	Nom:Mas+PL
néolocale	néolocal	Adj:Fem+SG
néolocales	néolocal	Adj:Fem+PL
néolocal	néolocal	Adj:Mas+SG
néolocaux	néolocal	Adj:Mas+PL
néologie	néologie	Nom:Fem+SG
néologique	néologique	Adj:InvGen+SG
néologiser	néologiser	Ver:Inf
néologisme	néologisme	Nom:Mas+SG
néologismes	néologisme	Nom:Mas+PL
néoménie	néoménie	Nom:Fem+SG
néomortalité	néomortalité	Nom:Fem+SG
néomycine	néomycine	Nom:Fem+SG
néonatale	néonatal	Adj:Fem+SG
néonatales	néonatal	Adj:Fem+PL
néonatal	néonatal	Adj:Mas+SG
néonatalogie	néonatalogie	Nom:Fem+SG
néonatals	néonatal	Adj:Mas+PL
néo	néo	Nom:Mas+SG
néon	néon	Nom:Mas+SG
néons	néon	Nom:Mas+PL
néophyte	néophyte	Adj:InvGen+SG
néophytes	néophyte	Adj:InvGen+PL
néopilina	néopilina	Nom:Fem+SG
néoplasie	néoplasie	Nom:Fem+SG
néoplasique	néoplasique	Adj:InvGen+SG
néoplasme	néoplasme	Nom:Mas+SG
néoplasticisme	néoplasticisme	Nom:Mas+SG
néoplastie	néoplastie	Nom:Fem+SG
néoplatonicien	néoplatonicien	Adj:Mas+SG
néopositivisme	néopositivisme	Nom:Mas+SG
néopositiviste	néopositiviste	Adj:InvGen+SG
néotectonique	néotectonique	Nom:Fem+SG
néotène	néotène	Nom:Mas+SG
néoténique	néoténique	Adj:InvGen+SG
néottie	néottie	Nom:Fem+SG
néozoïque	néozoïque	Adj:InvGen+SG
néozoïque	néozoïque	Nom:Mas+SG
néo-calédonien	néo-calédonien	Adj:Mas+SG
néo-celtique	néo-celtique	Adj:InvGen+SG
néo-classicisme	néo-classicisme	Nom:Mas+SG
néo-colonialisme	néo-colonialisme	Nom:Mas+SG
néo-criticisme	néo-criticisme	Nom:Mas+SG
néo-darwinisme	néo-darwinisme	Nom:Mas+SG
néo-gothique	néo-gothique	Adj:InvGen+SG
néo-gothique	néo-gothique	Nom:Fem+SG
néo-gothique	néo-gothique	Nom:Mas+SG
néo-grec	néo-grec	Adj:Mas+SG
néo-grecque	néo-grec	Adj:Fem+SG
néo-guinéen	néo-guinéen	Adj:Mas+SG
néo-hébridais	néo-hébridais	Adj:Mas+InvPL
néo-kantisme	néo-kantisme	Nom:Mas+SG
néo-natale	néo-natal	Adj:Fem+SG
néo-natal	néo-natal	Adj:Mas+SG
néo-natals	néo-natal	Adj:Mas+PL
néo-platonicien	néo-platonicien	Adj:Mas+SG
néo-platonicien	néo-platonicien	Nom:Mas+SG
néo-platonisme	néo-platonisme	Nom:Mas+SG
néo-positivisme	néo-positivisme	Nom:Mas+SG
néo-positiviste	néo-positiviste	Adj:InvGen+SG
néo-positiviste	néo-positiviste	Nom:InvGen+SG
néo-réalisme	néo-réalisme	Nom:Mas+SG
néo-réaliste	néo-réaliste	Adj:InvGen+SG
néo-thomisme	néo-thomisme	Nom:Mas+SG
néo-zélandais	néo-zélandais	Adj:Mas+InvPL
népalaise	népalais	Adj:Fem+SG
népalaise	népalais	Nom:Fem+SG
népalais	népalais	Adj:Mas+InvPL
népalais	népalais	Nom:Mas+InvPL
népalais	népalais	Nom:Mas+SG
népenthès	népenthès	Nom:Mas+InvPL
népérien	népérien	Adj:Mas+SG
népète	népète	Nom:Fem+SG
néphéline	néphéline	Nom:Fem+SG
néphélion	néphélion	Nom:Mas+SG
néphrectomie	néphrectomie	Nom:Fem+SG
néphrétique	néphrétique	Adj:InvGen+SG
néphrétiques	néphrétique	Adj:InvGen+PL
néphridie	néphridie	Nom:Fem+SG
néphrite	néphrite	Nom:Fem+SG
néphrites	néphrite	Nom:Fem+PL
néphrographie	néphrographie	Nom:Fem+SG
néphrologie	néphrologie	Nom:Fem+SG
néphrologue	néphrologue	Nom:InvGen+SG
néphrologues	néphrologue	Nom:InvGen+PL
néphron	néphron	Nom:Mas+SG
néphropathie	néphropathie	Nom:Fem+SG
néphropexie	néphropexie	Nom:Fem+SG
néphrose	néphrose	Nom:Fem+SG
népotisme	népotisme	Nom:Mas+SG
neptunium	neptunium	Nom:Mas+SG
néréide	néréide	Nom:Fem+SG
néréide	néréide	Nom:Mas+SG
néréides	néréide	Nom:Fem+PL
néréis	néréis	Nom:Fem+InvPL
nerf	nerf	Nom:Mas+SG
nerfs	nerf	Nom:Mas+PL
nerfs	nerfs	Nom:Mas+PL
néritique	néritique	Adj:InvGen+SG
néroli	néroli	Nom:Mas+SG
néronienne	néronien	Adj:Fem+SG
néronien	néronien	Adj:Mas+SG
néroniennes	néronien	Adj:Fem+PL
nerprun	nerprun	Nom:Mas+SG
nervation	nervation	Nom:Fem+SG
nervations	nervation	Nom:Fem+PL
nerveusement	nerveusement	Adv
nerveuse	nerveux	Adj:Fem+SG
nerveuse	nerveux	Nom:Fem+SG
nerveuses	nerveux	Adj:Fem+PL
nerveuses	nerveux	Nom:Fem+PL
nerveux	nerveux	Adj:Mas+InvPL
nerveux	nerveux	Nom:Mas+InvPL
nervi	nervi	Nom:Mas+SG
nervin	nervin	Adj:Mas+SG
nervin	nervin	Nom:Mas+SG
nervis	nervi	Nom:Mas+PL
nervosisme	nervosisme	Nom:Mas+SG
nervosité	nervosité	Nom:Fem+SG
nervosités	nervosité	Nom:Fem+PL
nervuraient	nervurer	Ver:IImp+PL+P3
nervurai	nervurer	Ver:IPSim+SG+P1
nervurais	nervurer	Ver:IImp+SG+P1:IImp+SG+P2
nervurait	nervurer	Ver:IImp+SG+P3
nervurâmes	nervurer	Ver:IPSim+PL+P1
nervura	nervurer	Ver:IPSim+SG+P3
nervurant	nervurer	Ver:PPre
nervuras	nervurer	Ver:IPSim+SG+P2
nervurasse	nervurer	Ver:SImp+SG+P1
nervurassent	nervurer	Ver:SImp+PL+P3
nervurasses	nervurer	Ver:SImp+SG+P2
nervurassiez	nervurer	Ver:SImp+PL+P2
nervurassions	nervurer	Ver:SImp+PL+P1
nervurâtes	nervurer	Ver:IPSim+PL+P2
nervurât	nervurer	Ver:SImp+SG+P3
nervurée	nervuré	Adj:Fem+SG
nervurée	nervurer	Ver:PPas+Fem+SG
nervurées	nervuré	Adj:Fem+PL
nervurées	nervurer	Ver:PPas+Fem+PL
nervuré	nervuré	Adj:Mas+SG
nervure	nervure	Nom:Fem+SG
nervure	nervurer	Ver:IPre+SG+P1:IPre+SG+P3:SPre+SG+P1:SPre+SG+P3:ImPre+SG+P2
nervuré	nervurer	Ver:PPas+Mas+SG
nervurent	nervurer	Ver:IPre+PL+P3:SPre+PL+P3
nervureraient	nervurer	Ver:CPre+PL+P3
nervurerai	nervurer	Ver:IFut+SG+P1
nervurerais	nervurer	Ver:CPre+SG+P1:CPre+SG+P2
nervurerait	nervurer	Ver:CPre+SG+P3
nervurera	nervurer	Ver:IFut+SG+P3
nervureras	nervurer	Ver:IFut+SG+P2
nervurèrent	nervurer	Ver:IPSim+PL+P3
nervurerez	nervurer	Ver:IFut+PL+P2
nervureriez	nervurer	Ver:CPre+PL+P2
nervurerions	nervurer	Ver:CPre+PL+P1
nervurer	nervurer	Ver:Inf
nervurerons	nervurer	Ver:IFut+PL+P1
nervureront	nervurer	Ver:IFut+PL+P3
nervures	nervure	Nom:Fem+PL
nervures	nervurer	Ver:IPre+SG+P2:SPre+SG+P2
nervurez	nervurer	Ver:IPre+PL+P2:ImPre+PL+P2
nervuriez	nervurer	Ver:IImp+PL+P2:SPre+PL+P2
nervurions	nervurer	Ver:IImp+PL+P1:SPre+PL+P1
nervurons	nervurer	Ver:IPre+PL+P1:ImPre+PL+P1
nescafé	nescafé	Nom:Mas+SG
nés	naître	Ver:PPas+Mas+PL
nés	né	Adj:Mas+PL
nés	né	Nom:Mas+PL
nestorianisme	nestorianisme	Nom:Mas+SG
nestorianismes	nestorianisme	Nom:Mas+PL
nestorienne	nestorien	Adj:Fem+SG
nestorienne	nestorien	Nom:Fem+SG
nestoriennes	nestorien	Adj:Fem+PL
nestoriennes	nestorien	Nom:Fem+PL
nestorien	nestorien	Adj:Mas+SG
nestoriens	nestorien	Adj:Mas+PL
nestoriens	nestorien	Nom:Mas+PL
net	net	Adj:InvGen+SG:InvGen+PL
net	net	Adj:Mas+SG
net	net	Adv
net	net	Nom:Mas+SG
nets	net	Adj:Mas+PL
nettement	nettement	Adv
nette	net	Adj:Fem+SG
nette	nette	Nom:Fem+SG
nettes	net	Adj:Fem+PL
nettes	nette	Nom:Fem+PL
netteté	netteté	Nom:Fem+SG
nettoiement	nettoiement	Nom:Mas+SG
nettoie	nettoyer	Ver:IPre+SG+P1:IPre+SG+P3:SPre+SG+P1:SPre+SG+P3:ImPre+SG+P2
nettoient	nettoyer	Ver:IPre+PL+P3:SPre+PL+P3
nettoieraient	nettoyer	Ver:CPre+PL+P3
nettoierai	nettoyer	Ver:IFut+SG+P1
nettoierais	nettoyer	Ver:CPre+SG+P1:CPre+SG+P2
nettoierait	nettoyer	Ver:CPre+SG+P3
nettoiera	nettoyer	Ver:IFut+SG+P3
nettoieras	nettoyer	Ver:IFut+SG+P2
nettoierez	nettoyer	Ver:IFut+PL+P2
nettoieriez	nettoyer	Ver:CPre+PL+P2
nettoierions	nettoyer	Ver:CPre+PL+P1
nettoierons	nettoyer	Ver:IFut+PL+P1
nettoieront	nettoyer	Ver:IFut+PL+P3
nettoies	nettoyer	Ver:IPre+SG+P2:SPre+SG+P2
nettoyage	nettoyage	Nom:Mas+SG
nettoyages	nettoyage	Nom:Mas+PL
nettoyaient	nettoyer	Ver:IImp+PL+P3
nettoyai	nettoyer	Ver:IPSim+SG+P1
nettoyais	nettoyer	Ver:IImp+SG+P1:IImp+SG+P2
nettoyait	nettoyer	Ver:IImp+SG+P3
nettoyâmes	nettoyer	Ver:IPSim+PL+P1
nettoya	nettoyer	Ver:IPSim+SG+P3
nettoyant	nettoyant	Adj:Mas+SG
nettoyant	nettoyant	Nom:Mas+SG
nettoyant	nettoyer	Ver:PPre
nettoyas	nettoyer	Ver:IPSim+SG+P2
nettoyasse	nettoyer	Ver:SImp+SG+P1
nettoyassent	nettoyer	Ver:SImp+PL+P3
nettoyasses	nettoyer	Ver:SImp+SG+P2
nettoyassiez	nettoyer	Ver:SImp+PL+P2
nettoyassions	nettoyer	Ver:SImp+PL+P1
nettoyâtes	nettoyer	Ver:IPSim+PL+P2
nettoyât	nettoyer	Ver:SImp+SG+P3
nettoyée	nettoyer	Ver:PPas+Fem+SG
nettoyées	nettoyer	Ver:PPas+Fem+PL
nettoyé	nettoyer	Ver:PPas+Mas+SG
nettoyèrent	nettoyer	Ver:IPSim+PL+P3
nettoyer	nettoyer	Ver:Inf
nettoyés	nettoyer	Ver:PPas+Mas+PL
nettoyeur	nettoyeur	Adj:Mas+SG
nettoyeur	nettoyeur	Nom:Mas+SG
nettoyeuse	nettoyeur	Adj:Fem+SG
nettoyeuse	nettoyeur	Nom:Fem+SG
nettoyez	nettoyer	Ver:IPre+PL+P2:ImPre+PL+P2
nettoyiez	nettoyer	Ver:IImp+PL+P2:SPre+PL+P2
nettoyions	nettoyer	Ver:IImp+PL+P1:SPre+PL+P1
nettoyons	nettoyer	Ver:IPre+PL+P1:ImPre+PL+P1
neuchâteloise	neuchâteloise	Nom:Fem+SG
neufchâtel	neufchâtel	Nom:Mas+SG
neuf	neuf	Adj:Mas+SG
neuf	neuf	Det:InvGen+PL
neuf	neuf	Nom:Mas+InvPL
neuf	neuf	Nom:Mas+SG
neufs	neuf	Adj:Mas+PL
neume	neume	Nom:Fem+SG
neume	neume	Nom:Mas+SG
neurale	neural	Adj:Fem+SG
neurales	neural	Adj:Fem+PL
neural	neural	Adj:Mas+SG
neurasthénie	neurasthénie	Nom:Fem+SG
neurasthénique	neurasthénique	Adj:InvGen+SG
neurasthénique	neurasthénique	Nom:InvGen+SG
neurasthéniques	neurasthénique	Adj:InvGen+PL
neurasthéniques	neurasthénique	Nom:InvGen+PL
neuraux	neural	Adj:Mas+PL
neurinome	neurinome	Nom:Mas+SG
neur	neuréguer	Ver:IPre+PL+P3:SPre+PL+P3
neurobiochimie	neurobiochimie	Nom:Fem+SG
neurobiochimique	neurobiochimique	Adj:InvGen+SG
neurobiologie	neurobiologie	Nom:Fem+SG
neuroblaste	neuroblaste	Nom:Mas+SG
neurochimie	neurochimie	Nom:Fem+SG
neurochimique	neurochimique	Adj:InvGen+SG
neurochirurgicale	neurochirurgical	Adj:Fem+SG
neurochirurgicales	neurochirurgical	Adj:Fem+PL
neurochirurgical	neurochirurgical	Adj:Mas+SG
neurochirurgicaux	neurochirurgical	Adj:Mas+PL
neurochirurgie	neurochirurgie	Nom:Fem+SG
neurochirurgienne	neurochirurgien	Nom:Fem+SG
neurochirurgiennes	neurochirurgien	Nom:Fem+PL
neurochirurgien	neurochirurgien	Nom:Mas+SG
neurodépresseur	neurodépresseur	Adj:Mas+SG
neurofibromatose	neurofibromatose	Nom:Fem+SG
neuroleptique	neuroleptique	Adj:InvGen+SG
neuroleptique	neuroleptique	Nom:Mas+SG
neuroleptiques	neuroleptique	Adj:InvGen+PL
neuroleptiques	neuroleptique	Nom:Mas+PL
neurolinguistique	neurolinguistique	Adj:InvGen+SG
neurolinguistique	neurolinguistique	Nom:Fem+SG
neurologie	neurologie	Nom:Fem+SG
neurologique	neurologique	Adj:InvGen+SG
neurologiques	neurologique	Adj:InvGen+PL
neurologiste	neurologiste	Nom:InvGen+SG
neurologue	neurologue	Nom:InvGen+SG
neurologues	neurologue	Nom:InvGen+PL
neurone	neurone	Nom:Mas+SG
neurones	neurone	Nom:Mas+PL
neuronique	neuronique	Adj:InvGen+SG
neuroniques	neuronique	Adj:InvGen+PL
neurophysiologie	neurophysiologie	Nom:Fem+SG
neurophysiologies	neurophysiologie	Nom:Fem+PL
neurophysiologique	neurophysiologique	Adj:InvGen+SG
neuroplégique	neuroplégique	Adj:InvGen+SG
neuroplégique	neuroplégique	Nom:Mas+SG
neuropsychiatre	neuropsychiatre	Nom:InvGen+SG
neuropsychiatrie	neuropsychiatrie	Nom:Fem+SG
neuropsychologie	neuropsychologie	Nom:Fem+SG
neuropsychologue	neuropsychologue	Nom:InvGen+SG
neuroradiologie	neuroradiologie	Nom:Fem+SG
neurosciences	neuroscience	Nom:Fem+PL
neurosciences	neurosciences	Nom:Fem+PL
neurosécrétion	neurosécrétion	Nom:Fem+SG
neurotomie	neurotomie	Nom:Fem+SG
neurotransmetteur	neurotransmetteur	Nom:Mas+SG
neurotransmission	neurotransmission	Nom:Fem+SG
neurotrope	neurotrope	Adj:InvGen+SG
neuro-végétatif	neuro-végétatif	Adj:Mas+SG
neurula	neurula	Nom:Fem+SG
neustrienne	neustrien	Adj:Fem+SG
neustrien	neustrien	Adj:Mas+SG
neutralisaient	neutraliser	Ver:IImp+PL+P3
neutralisai	neutraliser	Ver:IPSim+SG+P1
neutralisais	neutraliser	Ver:IImp+SG+P1:IImp+SG+P2
neutralisait	neutraliser	Ver:IImp+SG+P3
neutralisâmes	neutraliser	Ver:IPSim+PL+P1
neutralisa	neutraliser	Ver:IPSim+SG+P3
neutralisante	neutralisant	Adj:Fem+SG
neutralisantes	neutralisant	Adj:Fem+PL
neutralisant	neutralisant	Adj:Mas+SG
neutralisant	neutralisant	Nom:Mas+SG
neutralisant	neutraliser	Ver:PPre
neutralisas	neutraliser	Ver:IPSim+SG+P2
neutralisasse	neutraliser	Ver:SImp+SG+P1
neutralisassent	neutraliser	Ver:SImp+PL+P3
neutralisasses	neutraliser	Ver:SImp+SG+P2
neutralisassiez	neutraliser	Ver:SImp+PL+P2
neutralisassions	neutraliser	Ver:SImp+PL+P1
neutralisâtes	neutraliser	Ver:IPSim+PL+P2
neutralisation	neutralisation	Nom:Fem+SG
neutralisations	neutralisation	Nom:Fem+PL
neutralisât	neutraliser	Ver:SImp+SG+P3
neutralisée	neutraliser	Ver:PPas+Fem+SG
neutralisées	neutraliser	Ver:PPas+Fem+PL
neutralise	neutraliser	Ver:IPre+SG+P1:IPre+SG+P3:SPre+SG+P1:SPre+SG+P3:ImPre+SG+P2
neutralisé	neutraliser	Ver:PPas+Mas+SG
neutralisent	neutraliser	Ver:IPre+PL+P3:SPre+PL+P3
neutraliseraient	neutraliser	Ver:CPre+PL+P3
neutraliserai	neutraliser	Ver:IFut+SG+P1
neutraliserais	neutraliser	Ver:CPre+SG+P1:CPre+SG+P2
neutraliserait	neutraliser	Ver:CPre+SG+P3
neutralisera	neutraliser	Ver:IFut+SG+P3
neutraliseras	neutraliser	Ver:IFut+SG+P2
neutralisèrent	neutraliser	Ver:IPSim+PL+P3
neutraliserez	neutraliser	Ver:IFut+PL+P2
neutraliseriez	neutraliser	Ver:CPre+PL+P2
neutraliserions	neutraliser	Ver:CPre+PL+P1
neutraliser	neutraliser	Ver:Inf
neutraliserons	neutraliser	Ver:IFut+PL+P1
neutraliseront	neutraliser	Ver:IFut+PL+P3
neutralises	neutraliser	Ver:IPre+SG+P2:SPre+SG+P2
neutralisés	neutraliser	Ver:PPas+Mas+PL
neutralisez	neutraliser	Ver:IPre+PL+P2:ImPre+PL+P2
neutralisiez	neutraliser	Ver:IImp+PL+P2:SPre+PL+P2
neutralisions	neutraliser	Ver:IImp+PL+P1:SPre+PL+P1
neutralisme	neutralisme	Nom:Mas+SG
neutralisons	neutraliser	Ver:IPre+PL+P1:ImPre+PL+P1
neutraliste	neutraliste	Adj:InvGen+SG
neutraliste	neutraliste	Nom:InvGen+SG
neutralistes	neutraliste	Adj:InvGen+PL
neutralistes	neutraliste	Nom:InvGen+PL
neutralité	neutralité	Nom:Fem+SG
neutre	neutre	Adj:InvGen+SG
neutre	neutre	Nom:InvGen+SG
neutre	neutre	Nom:Mas+SG
neutres	neutre	Adj:InvGen+PL
neutrino	neutrino	Nom:Mas+SG
neutrinos	neutrino	Nom:Mas+PL
neutrographie	neutrographie	Nom:Fem+SG
neutrographie	neutrographier	Ver:IPre+SG+P1:IPre+SG+P3:SPre+SG+P1:SPre+SG+P3:ImPre+SG+P2
neutronique	neutronique	Adj:InvGen+SG
neutronique	neutronique	Nom:Fem+SG
neutron	neutron	Nom:Mas+SG
neutronographie	neutronographie	Nom:Fem+SG
neutrons	neutron	Nom:Mas+PL
neutrophile	neutrophile	Adj:InvGen+SG
neuvaine	neuvaine	Nom:Fem+SG
neuvaines	neuvaine	Nom:Fem+PL
neuve	neuf	Adj:Fem+SG
neuves	neuf	Adj:Fem+PL
neuvièmement	neuvièmement	Adv
neuvième	neuvième	Adj:InvGen+SG
neuvièmes	neuvième	Adj:InvGen+PL
névé	névé	Nom:Mas+SG
névés	névé	Nom:Mas+PL
neveu	neveu	Nom:Mas+SG
neveux	neveu	Nom:Mas+PL
névralgie	névralgie	Nom:Fem+SG
névralgies	névralgie	Nom:Fem+PL
névralgique	névralgique	Adj:InvGen+SG
névralgiques	névralgique	Adj:InvGen+PL
névraxe	névraxe	Nom:Mas+SG
névrilème	névrilème	Nom:Mas+SG
névrite	névrite	Nom:Fem+SG
névrites	névrite	Nom:Fem+PL
névritique	névritique	Adj:InvGen+SG
névrodermite	névrodermite	Nom:Fem+SG
névroglie	névroglie	Nom:Fem+SG
névroglique	névroglique	Adj:InvGen+SG
névropathe	névropathe	Adj:InvGen+SG
névropathe	névropathe	Nom:InvGen+SG
névropathie	névropathie	Nom:Fem+SG
névropathique	névropathique	Adj:InvGen+SG
névroptères	névroptère	Adj:InvGen+PL
névroptères	névroptère	Nom:Mas+PL
névrosée	névrosé	Adj:Fem+SG
névrosée	névrosé	Nom:Fem+SG
névrosée	névroser	Ver:PPas+Fem+SG
névrosées	névrosé	Adj:Fem+PL
névrosées	névrosé	Nom:Fem+PL
névrosées	névroser	Ver:PPas+Fem+PL
névrosé	névrosé	Adj:Mas+SG
névrose	névrose	Nom:Fem+SG
névrosé	névrosé	Nom:Mas+SG
névrose	névroser	Ver:IPre+SG+P1:IPre+SG+P3:SPre+SG+P1:SPre+SG+P3:ImPre+SG+P2
névrosé	névroser	Ver:PPas+Mas+SG
névrosés	névrosé	Adj:Mas+PL
névroses	névrose	Nom:Fem+PL
névrosés	névrosé	Nom:Mas+PL
névroses	névroser	Ver:IPre+SG+P2:SPre+SG+P2
névrosés	névroser	Ver:PPas+Mas+PL
névrotique	névrotique	Adj:InvGen+SG
névrotiques	névrotique	Adj:InvGen+PL
névrotomie	névrotomie	Nom:Fem+SG
newtonienne	newtonien	Adj:Fem+SG
newtoniennes	newtonien	Adj:Fem+PL
newtonien	newtonien	Adj:Mas+SG
new-yorkais	new-yorkais	Adj:Mas+InvPL
nez	nez	Nom:Mas+InvPL
niable	niable	Adj:InvGen+SG
niables	niable	Adj:InvGen+PL
niaient	nier	Ver:IImp+PL+P3
niai	nier	Ver:IPSim+SG+P1
niaisant	niaiser	Ver:PPre
niaisant	niaiser	Ver:PPre+Mas+SG
niaisement	niaisement	Adv
niaise	niais	Adj:Fem+SG
niaise	niaiser	Ver:IPre+SG+P1:IPre+SG+P3:SPre+SG+P1:SPre+SG+P3:ImPre+SG+P2
niaisé	niaiser	Ver:PPas
niaisé	niaiser	Ver:PPas+Mas+SG
niaise	niais	Nom:Fem+SG
niaiserie	niaiserie	Nom:Fem+SG
niaiseries	niaiserie	Nom:Fem+PL
niaiser	niaiser	Ver:Inf
niaises	niais	Adj:Fem+PL
niaises	niaiser	Ver:IPre+SG+P2:SPre+SG+P2
niaises	niais	Nom:Fem+PL
niais	niais	Adj:Mas+InvPL
niais	niais	Nom:Mas+InvPL
niais	nier	Ver:IImp+SG+P1:IImp+SG+P2
niait	nier	Ver:IImp+SG+P3
niâmes	nier	Ver:IPSim+PL+P1
nia	nier	Ver:IPSim+SG+P3
niant	nier	Ver:PPre
niaouli	niaouli	Nom:Mas+SG
nias	nier	Ver:IPSim+SG+P2
niasse	nier	Ver:SImp+SG+P1
niassent	nier	Ver:SImp+PL+P3
niasses	nier	Ver:SImp+SG+P2
niassiez	nier	Ver:SImp+PL+P2
niassions	nier	Ver:SImp+PL+P1
niâtes	nier	Ver:IPSim+PL+P2
niât	nier	Ver:SImp+SG+P3
nib	nib	Adv
nicaraguayen	nicaraguayen	Adj:Mas+SG
nicaraguayen	nicaraguayen	Nom:Mas+SG
nichaient	nicher	Ver:IImp+PL+P3
nichai	nicher	Ver:IPSim+SG+P1
nichais	nicher	Ver:IImp+SG+P1:IImp+SG+P2
nichait	nicher	Ver:IImp+SG+P3
nichâmes	nicher	Ver:IPSim+PL+P1
nicha	nicher	Ver:IPSim+SG+P3
nichant	nicher	Ver:PPre
nichas	nicher	Ver:IPSim+SG+P2
nichasse	nicher	Ver:SImp+SG+P1
nichassent	nicher	Ver:SImp+PL+P3
nichasses	nicher	Ver:SImp+SG+P2
nichassiez	nicher	Ver:SImp+PL+P2
nichassions	nicher	Ver:SImp+PL+P1
nichâtes	nicher	Ver:IPSim+PL+P2
nichât	nicher	Ver:SImp+SG+P3
nichée	nichée	Nom:Fem+SG
nichée	nicher	Ver:PPas+Fem+SG
nichées	nichée	Nom:Fem+PL
nichées	nicher	Ver:PPas+Fem+PL
niche	niche	Nom:Fem+SG
niche	nicher	Ver:IPre+SG+P1:IPre+SG+P3:SPre+SG+P1:SPre+SG+P3:ImPre+SG+P2
niché	nicher	Ver:PPas+Mas+SG
nichent	nicher	Ver:IPre+PL+P3:SPre+PL+P3
nicheraient	nicher	Ver:CPre+PL+P3
nicherai	nicher	Ver:IFut+SG+P1
nicherais	nicher	Ver:CPre+SG+P1:CPre+SG+P2
nicherait	nicher	Ver:CPre+SG+P3
nichera	nicher	Ver:IFut+SG+P3
nicheras	nicher	Ver:IFut+SG+P2
nichèrent	nicher	Ver:IPSim+PL+P3
nicherez	nicher	Ver:IFut+PL+P2
nicheriez	nicher	Ver:CPre+PL+P2
nicherions	nicher	Ver:CPre+PL+P1
nicher	nicher	Ver:Inf
nicherons	nicher	Ver:IFut+PL+P1
nicheront	nicher	Ver:IFut+PL+P3
niches	niche	Nom:Fem+PL
niches	nicher	Ver:IPre+SG+P2:SPre+SG+P2
nichés	nicher	Ver:PPas+Mas+PL
nichet	nichet	Nom:Mas+SG
nichez	nicher	Ver:IPre+PL+P2:ImPre+PL+P2
nichiez	nicher	Ver:IImp+PL+P2:SPre+PL+P2
nichions	nicher	Ver:IImp+PL+P1:SPre+PL+P1
nichoir	nichoir	Nom:Mas+SG
nichon	nichon	Nom:Mas+SG
nichons	nicher	Ver:IPre+PL+P1:ImPre+PL+P1
nichons	nichon	Nom:Mas+PL
nichrome	nichrome	Nom:Mas+SG
nickelage	nickelage	Nom:Mas+SG
nickelages	nickelage	Nom:Mas+PL
nickelant	nickeler	Ver:PPre
nickelée	nickelé	Adj:Fem+SG
nickelée	nickeler	Ver:PPas+Fem+SG
nickelées	nickelé	Adj:Fem+PL
nickelées	nickeler	Ver:PPas+Fem+PL
nickelé	nickelé	Adj:Mas+SG
nickelé	nickeler	Ver:PPas+Mas+SG
nickeler	nickeler	Ver:Inf
nickelés	nickelé	Adj:Mas+PL
nickelés	nickeler	Ver:PPas+Mas+PL
nickélifère	nickélifère	Adj:InvGen+SG
nickel	nickel	Adj:InvGen+SG:InvGen+PL
nickel	nickel	Nom:Mas+SG
nicodème	nicodème	Nom:Mas+SG
niçoise	niçois	Adj:Fem+SG
niçoises	niçois	Adj:Fem+PL
niçois	niçois	Adj:Mas+InvPL
nicolaïsme	nicolaïsme	Nom:Mas+SG
nicolaïte	nicolaïte	Nom:InvGen+SG
nicol	nicol	Nom:Mas+SG
nicols	nicol	Nom:Mas+PL
nicotine	nicotine	Nom:Fem+SG
nicotines	nicotine	Nom:Fem+PL
nicotinique	nicotinique	Adj:InvGen+SG
nicotinisé	nicotiniser	Ver:PPas
nicotinisé	nicotiniser	Ver:PPas+Mas+SG
nicotiniser	nicotiniser	Ver:Inf
nicotinisme	nicotinisme	Nom:Mas+SG
nictation	nictation	Nom:Fem+SG
nictitante	nictitant	Adj:Fem+SG
nictitantes	nictitant	Adj:Fem+PL
nictitant	nictitant	Adj:Mas+SG
nictitation	nictitation	Nom:Fem+SG
nidation	nidation	Nom:Fem+SG
nidifiant	nidifiant	Adj:Mas+SG
nidifiant	nidifier	Ver:PPre
nidification	nidification	Nom:Fem+SG
nidifié	nidifier	Ver:PPas+Mas+SG
nidifier	nidifier	Ver:Inf
nid	nid	Nom:Mas+SG
nids	nid	Nom:Mas+PL
nièce	nièce	Nom:Fem+SG
nièces	nièce	Nom:Fem+PL
niée	nier	Ver:PPas+Fem+SG
niées	nier	Ver:PPas+Fem+PL
niellage	niellage	Nom:Mas+SG
niellages	niellage	Nom:Mas+PL
niellaient	nieller	Ver:IImp+PL+P3
niellai	nieller	Ver:IPSim+SG+P1
niellais	nieller	Ver:IImp+SG+P1:IImp+SG+P2
niellait	nieller	Ver:IImp+SG+P3
niellâmes	nieller	Ver:IPSim+PL+P1
niella	nieller	Ver:IPSim+SG+P3
niellant	nieller	Ver:PPre
niellas	nieller	Ver:IPSim+SG+P2
niellasse	nieller	Ver:SImp+SG+P1
niellassent	nieller	Ver:SImp+PL+P3
niellasses	nieller	Ver:SImp+SG+P2
niellassiez	nieller	Ver:SImp+PL+P2
niellassions	nieller	Ver:SImp+PL+P1
niellâtes	nieller	Ver:IPSim+PL+P2
niellât	nieller	Ver:SImp+SG+P3
nielle	nielle	Nom:Fem+SG
nielle	nielle	Nom:Mas+SG
nielle	nieller	Ver:IPre+SG+P1:IPre+SG+P3:SPre+SG+P1:SPre+SG+P3:ImPre+SG+P2
niellé	nieller	Ver:PPas+Mas+SG
niellent	nieller	Ver:IPre+PL+P3:SPre+PL+P3
niellèrent	nieller	Ver:IPSim+PL+P3
nieller	nieller	Ver:Inf
nielles	nielle	Nom:Fem+PL
nielles	nielle	Nom:Mas+PL
nielles	nieller	Ver:IPre+SG+P2:SPre+SG+P2
nielleur	nielleur	Nom:Mas+SG
niellez	nieller	Ver:IPre+PL+P2:ImPre+PL+P2
nielliez	nieller	Ver:IImp+PL+P2:SPre+PL+P2
niellions	nieller	Ver:IImp+PL+P1:SPre+PL+P1
niellons	nieller	Ver:IPre+PL+P1:ImPre+PL+P1
niellure	niellure	Nom:Fem+SG
nième	nième	Adj:InvGen+SG
nie	nier	Ver:IPre+SG+P1:IPre+SG+P3:SPre+SG+P1:SPre+SG+P3:ImPre+SG+P2
nié	nier	Ver:PPas+Mas+SG
nient	nier	Ver:IPre+PL+P3:SPre+PL+P3
nieraient	nier	Ver:CPre+PL+P3
nierai	nier	Ver:IFut+SG+P1
nierais	nier	Ver:CPre+SG+P1:CPre+SG+P2
nierait	nier	Ver:CPre+SG+P3
niera	nier	Ver:IFut+SG+P3
nieras	nier	Ver:IFut+SG+P2
nièrent	nier	Ver:IPSim+PL+P3
nierez	nier	Ver:IFut+PL+P2
nieriez	nier	Ver:CPre+PL+P2
nierions	nier	Ver:CPre+PL+P1
nier	nier	Ver:Inf
nierons	nier	Ver:IFut+PL+P1
nieront	nier	Ver:IFut+PL+P3
nies	nier	Ver:IPre+SG+P2:SPre+SG+P2
niés	nier	Ver:PPas+Mas+PL
nietzschéenne	nietzschéen	Adj:Fem+SG
nietzschéenne	nietzschéen	Nom:Fem+SG
nietzschéennes	nietzschéen	Adj:Fem+PL
nietzschéennes	nietzschéen	Nom:Fem+PL
nietzschéen	nietzschéen	Adj:Mas+SG
nietzschéen	nietzschéen	Nom:Mas+SG
nietzschéisme	nietzschéisme	Nom:Mas+SG
niez	nier	Ver:IPre+PL+P2:ImPre+PL+P2
nife	nife	Nom:Mas+SG
nif	nif	Nom:Mas+SG
nigaudant	nigauder	Ver:PPre
nigaudant	nigauder	Ver:PPre+Mas+SG
nigaude	nigaud	Adj:Fem+SG
nigaude	nigauder	Ver:IPre+SG+P1:IPre+SG+P3:SPre+SG+P1:SPre+SG+P3:ImPre+SG+P2
nigaudé	nigauder	Ver:PPas
nigaudé	nigauder	Ver:PPas+Mas+SG
nigaude	nigaud	Nom:Fem+SG
nigauderie	nigauderie	Nom:Fem+SG
nigauder	nigauder	Ver:Inf
nigaudes	nigaud	Adj:Fem+PL
nigaudes	nigauder	Ver:IPre+SG+P2:SPre+SG+P2
nigaudes	nigaud	Nom:Fem+PL
nigaud	nigaud	Adj:Mas+SG
nigauds	nigaud	Adj:Mas+PL
nigauds	nigaud	Nom:Mas+PL
nigelle	nigelle	Nom:Fem+SG
nigérian	nigérian	Adj:Mas+SG
nigérienne	nigérien	Adj:Fem+SG
nigériennes	nigérien	Adj:Fem+PL
nigérien	nigérien	Adj:Mas+SG
nihilisme	nihilisme	Nom:Mas+SG
nihiliste	nihiliste	Adj:InvGen+SG
nihiliste	nihiliste	Nom:InvGen+SG
nihilistes	nihiliste	Adj:InvGen+PL
nihilistes	nihiliste	Nom:InvGen+PL
niiez	nier	Ver:IImp+PL+P2:SPre+PL+P2
niions	nier	Ver:IImp+PL+P1:SPre+PL+P1
nilgaut	nilgaut	Nom:Mas+SG
nille	nille	Nom:Fem+SG
nilles	nille	Nom:Fem+PL
nilotique	nilotique	Adj:InvGen+SG
nimbaient	nimber	Ver:IImp+PL+P3
nimbai	nimber	Ver:IPSim+SG+P1
nimbais	nimber	Ver:IImp+SG+P1:IImp+SG+P2
nimbait	nimber	Ver:IImp+SG+P3
nimbâmes	nimber	Ver:IPSim+PL+P1
nimba	nimber	Ver:IPSim+SG+P3
nimbant	nimber	Ver:PPre
nimbas	nimber	Ver:IPSim+SG+P2
nimbasse	nimber	Ver:SImp+SG+P1
nimbassent	nimber	Ver:SImp+PL+P3
nimbasses	nimber	Ver:SImp+SG+P2
nimbassiez	nimber	Ver:SImp+PL+P2
nimbassions	nimber	Ver:SImp+PL+P1
nimbâtes	nimber	Ver:IPSim+PL+P2
nimbât	nimber	Ver:SImp+SG+P3
nimbe	nimbe	Nom:Mas+SG
nimbe	nimber	Ver:IPre+SG+P1:IPre+SG+P3:SPre+SG+P1:SPre+SG+P3:ImPre+SG+P2
nimbé	nimber	Ver:PPas+Mas+SG
nimbent	nimber	Ver:IPre+PL+P3:SPre+PL+P3
nimbèrent	nimber	Ver:IPSim+PL+P3
nimber	nimber	Ver:Inf
nimbes	nimbe	Nom:Mas+PL
nimbes	nimber	Ver:IPre+SG+P2:SPre+SG+P2
nimbez	nimber	Ver:IPre+PL+P2:ImPre+PL+P2
nimbiez	nimber	Ver:IImp+PL+P2:SPre+PL+P2
nimbions	nimber	Ver:IImp+PL+P1:SPre+PL+P1
nimbons	nimber	Ver:IPre+PL+P1:ImPre+PL+P1
nimbus	nimbus	Nom:Mas+InvPL
nîmois	nîmois	Adj:Mas+InvPL
ninas	ninas	Nom:Mas+InvPL
ni	ni	Adv
ni	ni	Con
niobium	niobium	Nom:Mas+SG
niôle	niôle	Nom:Fem+SG
niolo	niolo	Nom:Mas+SG
nions	nier	Ver:IPre+PL+P1:ImPre+PL+P1
nippaient	nipper	Ver:IImp+PL+P3
nippai	nipper	Ver:IPSim+SG+P1
nippais	nipper	Ver:IImp+SG+P1:IImp+SG+P2
nippait	nipper	Ver:IImp+SG+P3
nippâmes	nipper	Ver:IPSim+PL+P1
nippa	nipper	Ver:IPSim+SG+P3
nippant	nipper	Ver:PPre
nippas	nipper	Ver:IPSim+SG+P2
nippasse	nipper	Ver:SImp+SG+P1
nippassent	nipper	Ver:SImp+PL+P3
nippasses	nipper	Ver:SImp+SG+P2
nippassiez	nipper	Ver:SImp+PL+P2
nippassions	nipper	Ver:SImp+PL+P1
nippâtes	nipper	Ver:IPSim+PL+P2
nippât	nipper	Ver:SImp+SG+P3
nippe	nippe	Nom:Fem+SG
nippe	nipper	Ver:IPre+SG+P1:IPre+SG+P3:SPre+SG+P1:SPre+SG+P3:ImPre+SG+P2
nippé	nipper	Ver:PPas+Mas+SG
nippent	nipper	Ver:IPre+PL+P3:SPre+PL+P3
nipperaient	nipper	Ver:CPre+PL+P3
nipperai	nipper	Ver:IFut+SG+P1
nipperais	nipper	Ver:CPre+SG+P1:CPre+SG+P2
nipperait	nipper	Ver:CPre+SG+P3
nippera	nipper	Ver:IFut+SG+P3
nipperas	nipper	Ver:IFut+SG+P2
nippèrent	nipper	Ver:IPSim+PL+P3
nipperez	nipper	Ver:IFut+PL+P2
nipperiez	nipper	Ver:CPre+PL+P2
nipperions	nipper	Ver:CPre+PL+P1
nipper	nipper	Ver:Inf
nipperons	nipper	Ver:IFut+PL+P1
nipperont	nipper	Ver:IFut+PL+P3
nippes	nippe	Nom:Fem+PL
nippes	nipper	Ver:IPre+SG+P2:SPre+SG+P2
nippez	nipper	Ver:IPre+PL+P2:ImPre+PL+P2
nippiez	nipper	Ver:IImp+PL+P2:SPre+PL+P2
nippions	nipper	Ver:IImp+PL+P1:SPre+PL+P1
nippone	nippon	Adj:Fem+SG
nippone	nippon	Nom:Fem+SG
nippones	nippon	Adj:Fem+PL
nippones	nippon	Nom:Fem+PL
nipponne	nippon	Adj:Fem+SG
nipponne	nippon	Nom:Fem+SG
nipponnes	nippon	Adj:Fem+PL
nipponnes	nippon	Nom:Fem+PL
nippon	nippon	Adj:Mas+SG
nippon	nippon	Nom:Mas+SG
nippons	nipper	Ver:IPre+PL+P1:ImPre+PL+P1
nippons	nippon	Adj:Mas+PL
nippons	nippon	Nom:Mas+PL
niquedouille	niquedouille	Adj:InvGen+SG
niquedouille	niquedouille	Nom:InvGen+SG
nique	nique	Nom:Fem+SG
niquer	niquer	Ver:Inf
niques	nique	Nom:Fem+PL
niqueur	niqueur	Nom:Mas+SG
niqueurs	niqueur	Nom:Mas+PL
nirvana	nirvana	Nom:Mas+SG
nitescence	nitescence	Nom:Fem+SG
nitouche	nitouche	Nom:Fem+SG
nitouches	nitouche	Nom:Fem+PL
nitraient	nitrer	Ver:IImp+PL+P3
nitrai	nitrer	Ver:IPSim+SG+P1
nitrais	nitrer	Ver:IImp+SG+P1:IImp+SG+P2
nitrait	nitrer	Ver:IImp+SG+P3
nitrâmes	nitrer	Ver:IPSim+PL+P1
nitra	nitrer	Ver:IPSim+SG+P3
nitrant	nitrant	Adj:Mas+SG
nitrant	nitrer	Ver:PPre
nitras	nitrer	Ver:IPSim+SG+P2
nitrasse	nitrer	Ver:SImp+SG+P1
nitrassent	nitrer	Ver:SImp+PL+P3
nitrasses	nitrer	Ver:SImp+SG+P2
nitrassiez	nitrer	Ver:SImp+PL+P2
nitrassions	nitrer	Ver:SImp+PL+P1
nitrataient	nitrater	Ver:IImp+PL+P3
nitratai	nitrater	Ver:IPSim+SG+P1
nitratais	nitrater	Ver:IImp+SG+P1:IImp+SG+P2
nitratait	nitrater	Ver:IImp+SG+P3
nitratâmes	nitrater	Ver:IPSim+PL+P1
nitrata	nitrater	Ver:IPSim+SG+P3
nitratant	nitrater	Ver:PPre
nitratas	nitrater	Ver:IPSim+SG+P2
nitratasse	nitrater	Ver:SImp+SG+P1
nitratassent	nitrater	Ver:SImp+PL+P3
nitratasses	nitrater	Ver:SImp+SG+P2
nitratassiez	nitrater	Ver:SImp+PL+P2
nitratassions	nitrater	Ver:SImp+PL+P1
nitratâtes	nitrater	Ver:IPSim+PL+P2
nitratation	nitratation	Nom:Fem+SG
nitratations	nitratation	Nom:Fem+PL
nitratât	nitrater	Ver:SImp+SG+P3
nitrate	nitrate	Nom:Mas+SG
nitraté	nitrater	Ver:PPas+Mas+SG
nitratent	nitrater	Ver:IPre+PL+P3:SPre+PL+P3
nitratèrent	nitrater	Ver:IPSim+PL+P3
nitrater	nitrater	Ver:Inf
nitrates	nitrate	Nom:Mas+PL
nitrates	nitrater	Ver:IPre+SG+P2:SPre+SG+P2
nitrâtes	nitrer	Ver:IPSim+PL+P2
nitratez	nitrater	Ver:IPre+PL+P2:ImPre+PL+P2
nitratiez	nitrater	Ver:IImp+PL+P2:SPre+PL+P2
nitration	nitration	Nom:Fem+SG
nitrations	nitrater	Ver:IImp+PL+P1:SPre+PL+P1
nitrations	nitration	Nom:Fem+PL
nitrât	nitrer	Ver:SImp+SG+P3
nitratons	nitrater	Ver:IPre+PL+P1:ImPre+PL+P1
nitrée	nitré	Adj:Fem+SG
nitrée	nitrer	Ver:PPas+Fem+SG
nitrées	nitré	Adj:Fem+PL
nitrées	nitrer	Ver:PPas+Fem+PL
nitré	nitré	Adj:Mas+SG
nitre	nitre	Nom:Mas+SG
nitre	nitrer	Ver:IPre+SG+P1:IPre+SG+P3:SPre+SG+P1:SPre+SG+P3:ImPre+SG+P2
nitré	nitrer	Ver:PPas+Mas+SG
nitrent	nitrer	Ver:IPre+PL+P3:SPre+PL+P3
nitrèrent	nitrer	Ver:IPSim+PL+P3
nitrer	nitrer	Ver:Inf
nitrés	nitré	Adj:Mas+PL
nitres	nitre	Nom:Mas+PL
nitrés	nitrer	Ver:PPas+Mas+PL
nitreuse	nitreux	Adj:Fem+SG
nitreuses	nitreux	Adj:Fem+PL
nitreux	nitreux	Adj:Mas+InvPL
nitrez	nitrer	Ver:IPre+PL+P2:ImPre+PL+P2
nitrière	nitrière	Nom:Fem+SG
nitriez	nitrer	Ver:IImp+PL+P2:SPre+PL+P2
nitrifiante	nitrifiant	Adj:Fem+SG
nitrifiantes	nitrifiant	Adj:Fem+PL
nitrifiant	nitrifiant	Adj:Mas+SG
nitrification	nitrification	Nom:Fem+SG
nitrifié	nitrifier	Ver:PPas+Mas+SG
nitrifier	nitrifier	Ver:Inf
nitrile	nitrile	Nom:Mas+SG
nitrions	nitrer	Ver:IImp+PL+P1:SPre+PL+P1
nitrique	nitrique	Adj:InvGen+SG
nitrite	nitrite	Nom:Mas+SG
nitrobacter	nitrobacter	Nom:Mas+SG
nitrobenzène	nitrobenzène	Nom:Mas+SG
nitrobenzine	nitrobenzine	Nom:Fem+SG
nitrocellulose	nitrocellulose	Nom:Fem+SG
nitrogène	nitrogène	Nom:Mas+SG
nitroglycérine	nitroglycérine	Nom:Fem+SG
nitrons	nitrer	Ver:IPre+PL+P1:ImPre+PL+P1
nitrons	nitron	Nom:Mas+PL
nitrophile	nitrophile	Adj:InvGen+SG
nitrosation	nitrosation	Nom:Fem+SG
nitrosé	nitrosé	Adj:Mas+SG
nitrosomonas	nitrosomonas	Nom:Mas+InvPL
nitrosyle	nitrosyle	Nom:Mas+SG
nitrotoluène	nitrotoluène	Nom:Mas+SG
nitruraient	nitrurer	Ver:IImp+PL+P3
nitrurai	nitrurer	Ver:IPSim+SG+P1
nitrurais	nitrurer	Ver:IImp+SG+P1:IImp+SG+P2
nitrurait	nitrurer	Ver:IImp+SG+P3
nitrurâmes	nitrurer	Ver:IPSim+PL+P1
nitrura	nitrurer	Ver:IPSim+SG+P3
nitrurant	nitrurant	Adj:Mas+SG
nitruras	nitrurer	Ver:IPSim+SG+P2
nitrurasse	nitrurer	Ver:SImp+SG+P1
nitrurassent	nitrurer	Ver:SImp+PL+P3
nitrurasses	nitrurer	Ver:SImp+SG+P2
nitrurassiez	nitrurer	Ver:SImp+PL+P2
nitrurassions	nitrurer	Ver:SImp+PL+P1
nitrurâtes	nitrurer	Ver:IPSim+PL+P2
nitruration	nitruration	Nom:Fem+SG
nitrurations	nitruration	Nom:Fem+PL
nitrurât	nitrurer	Ver:SImp+SG+P3
nitrurée	nitrurer	Ver:PPas+Fem+SG
nitrurées	nitrurer	Ver:PPas+Fem+PL
nitrure	nitrure	Nom:Mas+SG
nitruré	nitrurer	Ver:PPas+Mas+SG
nitrurent	nitrurer	Ver:IPre+PL+P3:SPre+PL+P3
nitrurèrent	nitrurer	Ver:IPSim+PL+P3
nitrurer	nitrurer	Ver:Inf
nitrures	nitrure	Nom:Mas+PL
nitrurez	nitrurer	Ver:IPre+PL+P2:ImPre+PL+P2
nitruriez	nitrurer	Ver:IImp+PL+P2:SPre+PL+P2
nitrurions	nitrurer	Ver:IImp+PL+P1:SPre+PL+P1
nitrurons	nitrurer	Ver:IPre+PL+P1:ImPre+PL+P1
nivale	nival	Adj:Fem+SG
nivales	nival	Adj:Fem+PL
nival	nival	Adj:Mas+SG
nivation	nivation	Nom:Fem+SG
nivaux	nival	Adj:Mas+PL
nivéale	nivéal	Adj:Fem+SG
nivéales	nivéal	Adj:Fem+PL
nivéal	nivéal	Adj:Mas+SG
niveau	niveau	Nom:Mas+SG
nivéaux	nivéal	Adj:Mas+PL
niveaux	niveau	Nom:Mas+PL
nivelage	nivelage	Nom:Mas+SG
nivelages	nivelage	Nom:Mas+PL
nivelaient	niveler	Ver:IImp+PL+P3
nivelai	niveler	Ver:IPSim+SG+P1
nivelais	niveler	Ver:IImp+SG+P1:IImp+SG+P2
nivelait	niveler	Ver:IImp+SG+P3
nivelâmes	niveler	Ver:IPSim+PL+P1
nivela	niveler	Ver:IPSim+SG+P3
nivelant	niveler	Ver:PPre
nivelas	niveler	Ver:IPSim+SG+P2
nivelasse	niveler	Ver:SImp+SG+P1
nivelassent	niveler	Ver:SImp+PL+P3
nivelasses	niveler	Ver:SImp+SG+P2
nivelassiez	niveler	Ver:SImp+PL+P2
nivelassions	niveler	Ver:SImp+PL+P1
nivelâtes	niveler	Ver:IPSim+PL+P2
nivelât	niveler	Ver:SImp+SG+P3
nivelée	niveler	Ver:PPas+Fem+SG
nivelées	niveler	Ver:PPas+Fem+PL
nivelé	niveler	Ver:PPas+Mas+SG
nivelèrent	niveler	Ver:IPSim+PL+P3
niveler	niveler	Ver:Inf
nivelés	niveler	Ver:PPas+Mas+PL
nivelette	nivelette	Nom:Fem+SG
niveleur	niveleur	Adj:Mas+SG
niveleur	niveleur	Nom:Mas+SG
niveleuse	niveleur	Adj:Fem+SG
niveleuse	niveleur	Nom:Fem+SG
niveleuse	niveleuse	Nom:Fem+SG
niveleuses	niveleur	Adj:Fem+PL
niveleuses	niveleur	Nom:Fem+PL
niveleuses	niveleuse	Nom:Fem+PL
nivelez	niveler	Ver:IPre+PL+P2:ImPre+PL+P2
niveliez	niveler	Ver:IImp+PL+P2:SPre+PL+P2
nivelions	niveler	Ver:IImp+PL+P1:SPre+PL+P1
nivellement	nivellement	Nom:Mas+SG
nivellements	nivellement	Nom:Mas+PL
nivelle	niveler	Ver:IPre+SG+P1:IPre+SG+P3:SPre+SG+P1:SPre+SG+P3:ImPre+SG+P2
nivelle	nivelle	Nom:Fem+SG
nivellent	niveler	Ver:IPre+PL+P3:SPre+PL+P3
nivelleraient	niveler	Ver:CPre+PL+P3
nivellerai	niveler	Ver:IFut+SG+P1
nivellerais	niveler	Ver:CPre+SG+P1:CPre+SG+P2
nivellerait	niveler	Ver:CPre+SG+P3
nivellera	niveler	Ver:IFut+SG+P3
nivelleras	niveler	Ver:IFut+SG+P2
nivellerez	niveler	Ver:IFut+PL+P2
nivelleriez	niveler	Ver:CPre+PL+P2
nivellerions	niveler	Ver:CPre+PL+P1
nivellerons	niveler	Ver:IFut+PL+P1
nivelleront	niveler	Ver:IFut+PL+P3
nivelles	niveler	Ver:IPre+SG+P2:SPre+SG+P2
nivelles	nivelle	Nom:Fem+PL
nivelons	niveler	Ver:IPre+PL+P1:ImPre+PL+P1
nivéole	nivéole	Nom:Fem+SG
nivernaise	nivernais	Adj:Fem+SG
nivernaise	nivernais	Nom:Fem+SG
nivernais	nivernais	Adj:Mas+InvPL
nivernais	nivernais	Nom:Mas+InvPL
nivôse	nivôse	Nom:Mas+SG
nivo-glaciaire	nivo-glaciaire	Adj:InvGen+SG
nivo-pluviale	nivo-pluvial	Adj:Fem+SG
nivo-pluvial	nivo-pluvial	Adj:Mas+SG
nivo-pluviaux	nivo-pluvial	Adj:Mas+PL
nixe	nixe	Nom:Fem+SG
nizeré	nizeré	Nom:Mas+SG
n	n	Nom:Mas+InvPL
nobélium	nobélium	Nom:Mas+SG
nobiliaire	nobiliaire	Adj:InvGen+SG
nobiliaire	nobiliaire	Nom:Mas+SG
nobiliaires	nobiliaire	Adj:InvGen+PL
nobiliaires	nobiliaire	Nom:Mas+PL
noblaillonne	noblaillon	Nom:Fem+SG
noblaillonnes	noblaillon	Nom:Fem+PL
noblaillon	noblaillon	Nom:Mas+SG
noblement	noblement	Adv
noble	noble	Adj:InvGen+SG
noble	noble	Nom:InvGen+SG
nobles	noble	Adj:InvGen+PL
nobles	noble	Nom:InvGen+PL
noblesse	noblesse	Nom:Fem+SG
noblesses	noblesse	Nom:Fem+PL
noblesses	noblesses	Nom:Fem+PL
nobliau	nobliau	Nom:Mas+SG
nobliaux	nobliau	Nom:Mas+PL
noce	noce	Nom:Fem+SG
noce	nocer	Ver:IPre+SG+P1:IPre+SG+P3:SPre+SG+P1:SPre+SG+P3:ImPre+SG+P2
noces	noce	Nom:Fem+PL
noces	nocer	Ver:IPre+SG+P2:SPre+SG+P2
noces	noces	Nom:Fem+PL
noceur	noceur	Adj:Mas+SG
noceurs	noceur	Adj:Mas+PL
noceurs	noceur	Nom:Mas+PL
noceuse	noceur	Adj:Fem+SG
noceuse	noceur	Nom:Fem+SG
noceuses	noceur	Adj:Fem+PL
noceuses	noceur	Nom:Fem+PL
nocher	nocher	Nom:Mas+SG
nociceptif	nociceptif	Adj:Mas+SG
nocif	nocif	Adj:Mas+SG
nocifs	nocif	Adj:Mas+PL
nocive	nocif	Adj:Fem+SG
nocives	nocif	Adj:Fem+PL
nocivité	nocivité	Nom:Fem+SG
noctambule	noctambule	Adj:InvGen+SG
noctambule	noctambule	Nom:InvGen+SG
noctambule	noctambuler	Ver:IPre+SG+P1:IPre+SG+P3:SPre+SG+P1:SPre+SG+P3:ImPre+SG+P2
noctambules	noctambule	Adj:InvGen+PL
noctambules	noctambule	Nom:InvGen+PL
noctambules	noctambuler	Ver:IPre+SG+P2:SPre+SG+P2
noctambulisme	noctambulisme	Nom:Mas+SG
noctiluque	noctiluque	Adj:InvGen+SG
noctiluque	noctiluque	Nom:Fem+SG
noctuelle	noctuelle	Nom:Fem+SG
noctule	noctule	Nom:Fem+SG
nocturne	nocturne	Adj:InvGen+SG
nocturnes	nocturne	Adj:InvGen+PL
nocuité	nocuité	Nom:Fem+SG
nodale	nodal	Adj:Fem+SG
nodale	nodale	Nom:Fem+SG
nodales	nodal	Adj:Fem+PL
nodales	nodale	Nom:Fem+PL
nodal	nodal	Adj:Mas+SG
nodaux	nodal	Adj:Mas+PL
nodosité	nodosité	Nom:Fem+SG
nodosités	nodosité	Nom:Fem+PL
nodulaire	nodulaire	Adj:InvGen+SG
nodule	nodule	Nom:Mas+SG
nodules	nodule	Nom:Mas+PL
noduleuse	noduleux	Adj:Fem+SG
noduleuses	noduleux	Adj:Fem+PL
noduleux	noduleux	Adj:Mas+InvPL
noël	noël	Nom:Mas+SG
noétique	noétique	Adj:InvGen+SG
noeud	noeud	Nom:Mas+SG
noeuds	noeud	Nom:Mas+PL
noie	noyer	Ver:IPre+SG+P1:IPre+SG+P3:SPre+SG+P1:SPre+SG+P3:ImPre+SG+P2
noient	noyer	Ver:IPre+PL+P3:SPre+PL+P3
noieraient	noyer	Ver:CPre+PL+P3
noierai	noyer	Ver:IFut+SG+P1
noierais	noyer	Ver:CPre+SG+P1:CPre+SG+P2
noierait	noyer	Ver:CPre+SG+P3
noiera	noyer	Ver:IFut+SG+P3
noieras	noyer	Ver:IFut+SG+P2
noierez	noyer	Ver:IFut+PL+P2
noieriez	noyer	Ver:CPre+PL+P2
noierions	noyer	Ver:CPre+PL+P1
noierons	noyer	Ver:IFut+PL+P1
noieront	noyer	Ver:IFut+PL+P3
noies	noyer	Ver:IPre+SG+P2:SPre+SG+P2
noirâtre	noirâtre	Adj:InvGen+SG
noirâtres	noirâtre	Adj:InvGen+PL
noiraude	noiraud	Adj:Fem+SG
noiraude	noiraud	Nom:Fem+SG
noiraudes	noiraud	Adj:Fem+PL
noiraudes	noiraud	Nom:Fem+PL
noiraud	noiraud	Adj:Mas+SG
noirauds	noiraud	Adj:Mas+PL
noirceur	noirceur	Nom:Fem+SG
noirceurs	noirceur	Nom:Fem+PL
noircie	noircir	Ver:PPas+Fem+SG
noircies	noircir	Ver:PPas+Fem+PL
noircîmes	noircir	Ver:IPSim+PL+P1
noirci	noircir	Ver:PPas+Mas+SG
noirciraient	noircir	Ver:CPre+PL+P3
noircirai	noircir	Ver:IFut+SG+P1
noircirais	noircir	Ver:CPre+SG+P1:CPre+SG+P2
noircirait	noircir	Ver:CPre+SG+P3
noircira	noircir	Ver:IFut+SG+P3
noirciras	noircir	Ver:IFut+SG+P2
noircirent	noircir	Ver:IPSim+PL+P3
noircirez	noircir	Ver:IFut+PL+P2
noirciriez	noircir	Ver:CPre+PL+P2
noircirions	noircir	Ver:CPre+PL+P1
noircir	noircir	Ver:Inf
noircirons	noircir	Ver:IFut+PL+P1
noirciront	noircir	Ver:IFut+PL+P3
noircis	noircir	Ver:PPas+Mas+PL:IPre+SG+P1:IPre+SG+P2:IPSim+SG+P1:IPSim+SG+P2:ImPre+SG+P2
noircissaient	noircir	Ver:IImp+PL+P3
noircissais	noircir	Ver:IImp+SG+P1:IImp+SG+P2
noircissait	noircir	Ver:IImp+SG+P3
noircissant	noircir	Ver:PPre
noircissant	noircir	Ver:PPre
noircissant	noircir	Ver:PPre+Mas+SG
noircissant	noircissant	Adj:Mas+SG
noircissement	noircissement	Nom:Mas+SG
noircisse	noircir	Ver:SPre+SG+P1:SPre+SG+P3:SImp+SG+P1
noircissent	noircir	Ver:IPre+PL+P3:SPre+PL+P3:SImp+PL+P3
noircisses	noircir	Ver:SPre+SG+P2:SImp+SG+P2
noircisseur	noircisseur	Nom:Mas+SG
noircissez	noircir	Ver:IPre+PL+P2:ImPre+PL+P2
noircissiez	noircir	Ver:IImp+PL+P2:SPre+PL+P2:SImp+PL+P2
noircissions	noircir	Ver:IImp+PL+P1:SPre+PL+P1:SImp+PL+P1
noircissons	noircir	Ver:IPre+PL+P1:ImPre+PL+P1
noircissure	noircissure	Nom:Fem+SG
noircissures	noircissure	Nom:Fem+PL
noircîtes	noircir	Ver:IPSim+PL+P2
noircit	noircir	Ver:IPre+SG+P3:IPSim+SG+P3
noircît	noircir	Ver:SImp+SG+P3
noire	noir	Adj:Fem+SG
noire	noire	Nom:Fem+SG
noire	noir	Nom:Fem+SG
noires	noir	Adj:Fem+PL
noires	noire	Nom:Fem+PL
noires	noir	Nom:Fem+PL
noir	noir	Adj:Mas+SG
noir	noir	Nom:Mas+SG
noirs	noir	Adj:Mas+PL
noirs	noir	Nom:Mas+PL
noise	noise	Nom:Fem+SG
noiseraie	noiseraie	Nom:Fem+SG
noiseraies	noiseraie	Nom:Fem+PL
noises	noise	Nom:Fem+PL
noisetier	noisetier	Nom:Mas+SG
noisetiers	noisetier	Nom:Mas+PL
noisette	noisette	Adj:InvGen+SG:InvGen+PL
noisette	noisette	Nom:Fem+SG
noisettes	noisette	Nom:Fem+PL
noisettes	noisettes	Nom:Fem+PL
noix	noix	Nom:Fem+InvPL
nolisant	noliser	Ver:PPre
nolisé	noliser	Ver:PPas+Mas+SG
noliser	noliser	Ver:Inf
nolis	nolis	Nom:Mas+InvPL
noli-me-tangere	noli-me-tangere	Nom:Mas+InvPL
nomade	nomade	Adj:InvGen+SG
nomade	nomade	Nom:Fem+SG
nomade	nomade	Nom:InvGen+SG
nomades	nomade	Adj:InvGen+PL
nomades	nomade	Nom:Fem+PL
nomades	nomade	Nom:InvGen+PL
nomadisé	nomadiser	Ver:PPas
nomadisé	nomadiser	Ver:PPas+Mas+SG
nomadiser	nomadiser	Ver:Inf
nomadisme	nomadisme	Nom:Mas+SG
nombrable	nombrable	Adj:InvGen+SG
nombrables	nombrable	Adj:InvGen+PL
nombraient	nombrer	Ver:IImp+PL+P3
nombrai	nombrer	Ver:IPSim+SG+P1
nombrais	nombrer	Ver:IImp+SG+P1:IImp+SG+P2
nombrait	nombrer	Ver:IImp+SG+P3
nombrâmes	nombrer	Ver:IPSim+PL+P1
nombra	nombrer	Ver:IPSim+SG+P3
nombrant	nombrer	Ver:PPre
nombras	nombrer	Ver:IPSim+SG+P2
nombrasse	nombrer	Ver:SImp+SG+P1
nombrassent	nombrer	Ver:SImp+PL+P3
nombrasses	nombrer	Ver:SImp+SG+P2
nombrassiez	nombrer	Ver:SImp+PL+P2
nombrassions	nombrer	Ver:SImp+PL+P1
nombrâtes	nombrer	Ver:IPSim+PL+P2
nombrât	nombrer	Ver:SImp+SG+P3
nombrée	nombré	Adj:Fem+SG
nombrée	nombrer	Ver:PPas+Fem+SG
nombrées	nombré	Adj:Fem+PL
nombrées	nombrer	Ver:PPas+Fem+PL
nombré	nombré	Adj:Mas+SG
nombre	nombre	Nom:Mas+SG
nombre	nombrer	Ver:IPre+SG+P1:IPre+SG+P3:SPre+SG+P1:SPre+SG+P3:ImPre+SG+P2
nombré	nombrer	Ver:PPas+Mas+SG
nombrent	nombrer	Ver:IPre+PL+P3:SPre+PL+P3
nombreraient	nombrer	Ver:CPre+PL+P3
nombrerai	nombrer	Ver:IFut+SG+P1
nombrerais	nombrer	Ver:CPre+SG+P1:CPre+SG+P2
nombrerait	nombrer	Ver:CPre+SG+P3
nombrera	nombrer	Ver:IFut+SG+P3
nombreras	nombrer	Ver:IFut+SG+P2
nombrèrent	nombrer	Ver:IPSim+PL+P3
nombrerez	nombrer	Ver:IFut+PL+P2
nombreriez	nombrer	Ver:CPre+PL+P2
nombrerions	nombrer	Ver:CPre+PL+P1
nombrer	nombrer	Ver:Inf
nombrerons	nombrer	Ver:IFut+PL+P1
nombreront	nombrer	Ver:IFut+PL+P3
nombrés	nombré	Adj:Mas+PL
nombres	nombre	Nom:Mas+PL
nombres	nombrer	Ver:IPre+SG+P2:SPre+SG+P2
nombrés	nombrer	Ver:PPas+Mas+PL
nombreuse	nombreux	Adj:Fem+SG
nombreuses	nombreux	Adj:Fem+PL
nombreux	nombreux	Adj:Mas+InvPL
nombrez	nombrer	Ver:IPre+PL+P2:ImPre+PL+P2
nombriez	nombrer	Ver:IImp+PL+P2:SPre+PL+P2
nombrilisme	nombrilisme	Nom:Mas+SG
nombril	nombril	Nom:Mas+SG
nombrils	nombril	Nom:Mas+PL
nombrions	nombrer	Ver:IImp+PL+P1:SPre+PL+P1
nombrons	nombrer	Ver:IPre+PL+P1:ImPre+PL+P1
nomenclateur	nomenclateur	Adj:Mas+SG
nomenclateur	nomenclateur	Nom:Mas+SG
nomenclature	nomenclature	Nom:Fem+SG
nomenclature	nomenclaturer	Ver:IPre+SG+P1:IPre+SG+P3:SPre+SG+P1:SPre+SG+P3:ImPre+SG+P2
nomenclatures	nomenclature	Nom:Fem+PL
nomenclatures	nomenclaturer	Ver:IPre+SG+P2:SPre+SG+P2
nome	nome	Nom:Mas+SG
nomes	nome	Nom:Mas+PL
nominalement	nominalement	Adv
nominale	nominal	Adj:Fem+SG
nominales	nominal	Adj:Fem+PL
nominaliser	nominaliser	Ver:Inf
nominalisme	nominalisme	Nom:Mas+SG
nominaliste	nominaliste	Adj:InvGen+SG
nominaliste	nominaliste	Nom:InvGen+SG
nominal	nominal	Adj:Mas+SG
nominatif	nominatif	Adj:Mas+SG
nominatifs	nominatif	Adj:Mas+PL
nominatifs	nominatif	Nom:Mas+PL
nomination	nomination	Nom:Fem+SG
nominations	nomination	Nom:Fem+PL
nominativement	nominativement	Adv
nominative	nominatif	Adj:Fem+SG
nominatives	nominatif	Adj:Fem+PL
nominaux	nominal	Adj:Mas+PL
nominaux	nominal	Nom:Mas+PL
nommaient	nommer	Ver:IImp+PL+P3
nommai	nommer	Ver:IPSim+SG+P1
nommais	nommer	Ver:IImp+SG+P1:IImp+SG+P2
nommait	nommer	Ver:IImp+SG+P3
nommâmes	nommer	Ver:IPSim+PL+P1
nomma	nommer	Ver:IPSim+SG+P3
nommant	nommer	Ver:PPre
nommas	nommer	Ver:IPSim+SG+P2
nommasse	nommer	Ver:SImp+SG+P1
nommassent	nommer	Ver:SImp+PL+P3
nommasses	nommer	Ver:SImp+SG+P2
nommassiez	nommer	Ver:SImp+PL+P2
nommassions	nommer	Ver:SImp+PL+P1
nommâtes	nommer	Ver:IPSim+PL+P2
nommât	nommer	Ver:SImp+SG+P3
nommée	nommé	Adj:Fem+SG
nommées	nommé	Adj:Fem+PL
nommément	nommément	Adv
nommé	nommé	Adj:Mas+SG
nomme	nommer	Ver:IPre+SG+P1:IPre+SG+P3:SPre+SG+P1:SPre+SG+P3:ImPre+SG+P2
nommé	nommer	Ver:PPas+Mas+SG
nomment	nommer	Ver:IPre+PL+P3:SPre+PL+P3
nommeraient	nommer	Ver:CPre+PL+P3
nommerai	nommer	Ver:IFut+SG+P1
nommerais	nommer	Ver:CPre+SG+P1:CPre+SG+P2
nommerait	nommer	Ver:CPre+SG+P3
nommera	nommer	Ver:IFut+SG+P3
nommeras	nommer	Ver:IFut+SG+P2
nommèrent	nommer	Ver:IPSim+PL+P3
nommerez	nommer	Ver:IFut+PL+P2
nommeriez	nommer	Ver:CPre+PL+P2
nommerions	nommer	Ver:CPre+PL+P1
nommer	nommer	Ver:Inf
nommerons	nommer	Ver:IFut+PL+P1
nommeront	nommer	Ver:IFut+PL+P3
nommés	nommé	Adj:Mas+PL
nommes	nommer	Ver:IPre+SG+P2:SPre+SG+P2
nommez	nommer	Ver:IPre+PL+P2:ImPre+PL+P2
nommiez	nommer	Ver:IImp+PL+P2:SPre+PL+P2
nommions	nommer	Ver:IImp+PL+P1:SPre+PL+P1
nommons	nommer	Ver:IPre+PL+P1:ImPre+PL+P1
nom	nom	Nom:Mas+SG
nomogramme	nomogramme	Nom:Mas+SG
nomogrammes	nomogramme	Nom:Mas+PL
nomographie	nomographie	Nom:Fem+SG
nomographies	nomographie	Nom:Fem+PL
noms	nom	Nom:Mas+PL
nonagénaire	nonagénaire	Adj:InvGen+SG
nonagénaire	nonagénaire	Nom:InvGen+SG
nonagénaires	nonagénaire	Adj:InvGen+PL
nonagénaires	nonagénaire	Nom:InvGen+PL
nonante	nonante	Det:InvGen+PL
nonantième	nonantième	Adj:InvGen+SG
nonantième	nonantième	Nom:InvGen+SG
nonantième	nonantième	Nom:Mas+SG
nonantièmes	nonantième	Adj:InvGen+PL
nonantièmes	nonantième	Nom:InvGen+PL
nonantièmes	nonantième	Nom:Mas+PL
nonce	nonce	Nom:Mas+SG
nonces	nonce	Nom:Mas+PL
nonchalamment	nonchalamment	Adv
nonchalance	nonchalance	Nom:Fem+SG
nonchalances	nonchalance	Nom:Fem+PL
nonchalante	nonchalant	Adj:Fem+SG
nonchalante	nonchalant	Nom:Fem+SG
nonchalantes	nonchalant	Adj:Fem+PL
nonchalantes	nonchalant	Nom:Fem+PL
nonchalant	nonchalant	Adj:Mas+SG
nonchalant	nonchalant	Nom:Mas+SG
nonchalants	nonchalant	Adj:Mas+PL
nonchalants	nonchalant	Nom:Mas+PL
nonchaloir	nonchaloir	Nom:Mas+SG
nonciature	nonciature	Nom:Fem+SG
none	none	Nom:Fem+SG
nones	none	Nom:Fem+PL
nones	nones	Nom:Fem+PL
nonidi	nonidi	Nom:Mas+SG
nonidis	nonidi	Nom:Mas+PL
nonne	nonne	Nom:Fem+SG
nonne	nonne	Nom:Mas+SG
nonnes	nonne	Nom:Fem+PL
nonnes	nonne	Nom:Mas+PL
nonnette	nonnette	Nom:Fem+SG
non	non	Adv
non	non	Nom:Mas+InvPL
nonobstant	nonobstant	Adv
nonobstant	nonobstant	Pre
nô	nô	Nom:Mas+InvPL
nonpareille	nonpareil	Adj:Fem+SG
nonpareille	nonpareille	Nom:Fem+SG
nonpareilles	nonpareil	Adj:Fem+PL
nonpareilles	nonpareille	Nom:Fem+PL
nonpareil	nonpareil	Adj:Mas+SG
nonpareils	nonpareil	Adj:Mas+PL
nonupler	nonupler	Ver:Inf
non-agression	non-agression	Nom:Fem+SG
non-alignée	non-aligné	Adj:Fem+SG
non-alignées	non-aligné	Adj:Fem+PL
non-alignement	non-alignement	Nom:Mas+SG
non-aligné	non-aligné	Adj:Mas+SG
non-alignés	non-aligné	Adj:Mas+PL
non-assistance	non-assistance	Nom:Fem+SG
non-belligérante	non-belligérant	Adj:Fem+SG
non-belligérantes	non-belligérant	Adj:Fem+PL
non-belligérant	non-belligérant	Adj:Mas+SG
non-belligérants	non-belligérant	Adj:Mas+PL
non-combattante	non-combattant	Adj:Fem+SG
non-combattante	non-combattant	Nom:Fem+SG
non-combattantes	non-combattant	Adj:Fem+PL
non-combattantes	non-combattant	Nom:Fem+PL
non-combattant	non-combattant	Adj:Mas+SG
non-combattant	non-combattant	Nom:Mas+SG
non-combattants	non-combattant	Adj:Mas+PL
non-combattants	non-combattant	Nom:Mas+PL
non-comparant	non-comparant	Adj:Mas+SG
non-comparant	non-comparant	Nom:Mas+SG
non-comparution	non-comparution	Nom:Fem+SG
non-conciliation	non-conciliation	Nom:Fem+SG
non-conformisme	non-conformisme	Nom:Mas+SG
non-conformiste	non-conformiste	Adj:InvGen+SG
non-conformiste	non-conformiste	Nom:InvGen+SG
non-conformistes	non-conformiste	Adj:InvGen+PL
non-conformistes	non-conformiste	Nom:InvGen+PL
non-conformité	non-conformité	Nom:Fem+SG
non-contradiction	non-contradiction	Nom:Fem+SG
non-disponibilité	non-disponibilité	Nom:Fem+SG
non-engagée	non-engagé	Adj:Fem+SG
non-engagées	non-engagé	Adj:Fem+PL
non-engagé	non-engagé	Adj:Mas+SG
non-engagés	non-engagé	Adj:Mas+PL
non-être	non-être	Nom:Mas+SG
non-euclidien	non-euclidien	Adj:Mas+SG
non-exécution	non-exécution	Nom:Fem+SG
non-existence	non-existence	Nom:Fem+SG
non-figuratif	non-figuratif	Adj:Mas+SG
non-figuratifs	non-figuratif	Adj:Mas+PL
non-figurative	non-figuratif	Adj:Fem+SG
non-figuratives	non-figuratif	Adj:Fem+PL
non-initiée	non-initié	Adj:Fem+SG
non-initiée	non-initié	Nom:Fem+SG
non-initiées	non-initié	Adj:Fem+PL
non-initiées	non-initié	Nom:Fem+PL
non-initié	non-initié	Adj:Mas+SG
non-initié	non-initié	Nom:Mas+SG
non-initiés	non-initié	Adj:Mas+PL
non-initiés	non-initié	Nom:Mas+PL
non-inscrite	non-inscrit	Adj:Fem+SG
non-inscrite	non-inscrit	Nom:Fem+SG
non-inscrites	non-inscrit	Adj:Fem+PL
non-inscrites	non-inscrit	Nom:Fem+PL
non-inscrit	non-inscrit	Adj:Mas+SG
non-inscrit	non-inscrit	Nom:Mas+SG
non-inscrits	non-inscrit	Adj:Mas+PL
non-inscrits	non-inscrit	Nom:Mas+PL
non-intervention	non-intervention	Nom:Fem+SG
non-lieu	non-lieu	Nom:Mas+SG
non-lieux	non-lieu	Nom:Mas+PL
non-moi	non-moi	Nom:Mas+InvPL
non-paiement	non-paiement	Nom:Mas+SG
non-recevoir	non-recevoir	Nom:Mas+SG
non-satisfaction	non-satisfaction	Nom:Fem+SG
non-sens	non-sens	Nom:Mas+InvPL
non-usage	non-usage	Nom:Mas+SG
non-valeur	non-valeur	Nom:Fem+SG
non-violence	non-violence	Nom:Fem+SG
non-violente	non-violent	Adj:Fem+SG
non-violentes	non-violent	Adj:Fem+PL
non-violent	non-violent	Adj:Mas+SG
non-violents	non-violent	Adj:Mas+PL
noologique	noologique	Adj:InvGen+SG
nopal	nopal	Nom:Mas+SG
nopals	nopal	Nom:Mas+PL
noradrénaline	noradrénaline	Nom:Fem+SG
noradrénalines	noradrénaline	Nom:Fem+PL
nordîmes	nordir	Ver:IPSim+PL+P1
nordi	nordir	Ver:PPas+Mas+SG
nordique	nordique	Adj:InvGen+SG
nordiques	nordique	Adj:InvGen+PL
nordiraient	nordir	Ver:CPre+PL+P3
nordirai	nordir	Ver:IFut+SG+P1
nordirais	nordir	Ver:CPre+SG+P1:CPre+SG+P2
nordirait	nordir	Ver:CPre+SG+P3
nordira	nordir	Ver:IFut+SG+P3
nordiras	nordir	Ver:IFut+SG+P2
nordirent	nordir	Ver:IPSim+PL+P3
nordirez	nordir	Ver:IFut+PL+P2
nordiriez	nordir	Ver:CPre+PL+P2
nordirions	nordir	Ver:CPre+PL+P1
nordir	nordir	Ver:Inf
nordirons	nordir	Ver:IFut+PL+P1
nordiront	nordir	Ver:IFut+PL+P3
nordis	nordir	Ver:IPre+SG+P1:IPre+SG+P2:IPSim+SG+P1:IPSim+SG+P2:ImPre+SG+P2
nordissaient	nordir	Ver:IImp+PL+P3
nordissais	nordir	Ver:IImp+SG+P1:IImp+SG+P2
nordissait	nordir	Ver:IImp+SG+P3
nordissant	nordir	Ver:PPre
nordisse	nordir	Ver:SPre+SG+P1:SPre+SG+P3:SImp+SG+P1
nordissent	nordir	Ver:IPre+PL+P3:SPre+PL+P3:SImp+PL+P3
nordisses	nordir	Ver:SPre+SG+P2:SImp+SG+P2
nordissez	nordir	Ver:IPre+PL+P2:ImPre+PL+P2
nordissiez	nordir	Ver:IImp+PL+P2:SPre+PL+P2:SImp+PL+P2
nordissions	nordir	Ver:IImp+PL+P1:SPre+PL+P1:SImp+PL+P1
nordissons	nordir	Ver:IPre+PL+P1:ImPre+PL+P1
nordiste	nordiste	Adj:InvGen+SG
nordistes	nordiste	Adj:InvGen+PL
nordit	nordir	Ver:IPre+SG+P3:IPSim+SG+P3
nordît	nordir	Ver:SImp+SG+P3
nord	nord	Adj:InvGen+SG:InvGen+PL
nord	nord	Nom:Mas+SG
nord-africaine	nord-africain	Adj:Fem+SG
nord-africaines	nord-africain	Adj:Fem+PL
nord-africain	nord-africain	Adj:Mas+SG
nord-africains	nord-africain	Adj:Mas+PL
nord-américaine	nord-américain	Adj:Fem+SG
nord-américaines	nord-américain	Adj:Fem+PL
nord-américain	nord-américain	Adj:Mas+SG
nord-américains	nord-américain	Adj:Mas+PL
nord-coréenne	nord-coréen	Adj:Fem+SG
nord-coréennes	nord-coréen	Adj:Fem+PL
nord-coréen	nord-coréen	Adj:Mas+SG
nord-coréens	nord-coréen	Adj:Mas+PL
nord-est	nord-est	Nom:Mas+InvPL
nord-ouest	nord-ouest	Nom:Mas+InvPL
nord-vietnamien	nord-vietnamien	Adj:Mas+SG
noria	noria	Nom:Fem+SG
norias	noria	Nom:Fem+PL
normalement	normalement	Adv
normale	normal	Adj:Fem+SG
normale	normale	Nom:Fem+SG
normales	normal	Adj:Fem+PL
normales	normale	Nom:Fem+PL
normalienne	normalien	Nom:Fem+SG
normaliennes	normalien	Nom:Fem+PL
normalien	normalien	Nom:Mas+SG
normaliens	normalien	Nom:Mas+PL
normalisaient	normaliser	Ver:IImp+PL+P3
normalisai	normaliser	Ver:IPSim+SG+P1
normalisais	normaliser	Ver:IImp+SG+P1:IImp+SG+P2
normalisait	normaliser	Ver:IImp+SG+P3
normalisâmes	normaliser	Ver:IPSim+PL+P1
normalisa	normaliser	Ver:IPSim+SG+P3
normalisant	normaliser	Ver:PPre
normalisas	normaliser	Ver:IPSim+SG+P2
normalisasse	normaliser	Ver:SImp+SG+P1
normalisassent	normaliser	Ver:SImp+PL+P3
normalisasses	normaliser	Ver:SImp+SG+P2
normalisassiez	normaliser	Ver:SImp+PL+P2
normalisassions	normaliser	Ver:SImp+PL+P1
normalisâtes	normaliser	Ver:IPSim+PL+P2
normalisation	normalisation	Nom:Fem+SG
normalisations	normalisation	Nom:Fem+PL
normalisât	normaliser	Ver:SImp+SG+P3
normalisée	normalisé	Adj:Fem+SG
normalisée	normaliser	Ver:PPas+Fem+SG
normalisées	normalisé	Adj:Fem+PL
normalisées	normaliser	Ver:PPas+Fem+PL
normalisé	normalisé	Adj:Mas+SG
normalise	normaliser	Ver:IPre+SG+P1:IPre+SG+P3:SPre+SG+P1:SPre+SG+P3:ImPre+SG+P2
normalisé	normaliser	Ver:PPas+Mas+SG
normalisent	normaliser	Ver:IPre+PL+P3:SPre+PL+P3
normaliseraient	normaliser	Ver:CPre+PL+P3
normaliserai	normaliser	Ver:IFut+SG+P1
normaliserais	normaliser	Ver:CPre+SG+P1:CPre+SG+P2
normaliserait	normaliser	Ver:CPre+SG+P3
normalisera	normaliser	Ver:IFut+SG+P3
normaliseras	normaliser	Ver:IFut+SG+P2
normalisèrent	normaliser	Ver:IPSim+PL+P3
normaliserez	normaliser	Ver:IFut+PL+P2
normaliseriez	normaliser	Ver:CPre+PL+P2
normaliserions	normaliser	Ver:CPre+PL+P1
normaliser	normaliser	Ver:Inf
normaliserons	normaliser	Ver:IFut+PL+P1
normaliseront	normaliser	Ver:IFut+PL+P3
normalisés	normalisé	Adj:Mas+PL
normalises	normaliser	Ver:IPre+SG+P2:SPre+SG+P2
normalisés	normaliser	Ver:PPas+Mas+PL
normalisez	normaliser	Ver:IPre+PL+P2:ImPre+PL+P2
normalisiez	normaliser	Ver:IImp+PL+P2:SPre+PL+P2
normalisions	normaliser	Ver:IImp+PL+P1:SPre+PL+P1
normalisons	normaliser	Ver:IPre+PL+P1:ImPre+PL+P1
normalité	normalité	Nom:Fem+SG
normalités	normalité	Nom:Fem+PL
normal	normal	Adj:Mas+SG
normande	normand	Adj:Fem+SG
normande	normande	Nom:Fem+SG
normande	normander	Ver:IPre+SG+P1:IPre+SG+P3:SPre+SG+P1:SPre+SG+P3:ImPre+SG+P2
normande	normand	Nom:Fem+SG
normandes	normand	Adj:Fem+PL
normandes	normande	Nom:Fem+PL
normandes	normander	Ver:IPre+SG+P2:SPre+SG+P2
normandes	normand	Nom:Fem+PL
normand	normand	Adj:Mas+SG
normand	normand	Nom:Mas+SG
normands	normand	Adj:Mas+PL
normands	normand	Nom:Mas+PL
normatif	normatif	Adj:Mas+SG
normatifs	normatif	Adj:Mas+PL
normative	normatif	Adj:Fem+SG
normatives	normatif	Adj:Fem+PL
normativité	normativité	Nom:Fem+SG
normaux	normal	Adj:Mas+PL
normée	normé	Adj:Fem+SG
normée	normer	Ver:PPas+Fem+SG
normées	normé	Adj:Fem+PL
normées	normer	Ver:PPas+Fem+PL
normé	normé	Adj:Mas+SG
norme	norme	Nom:Fem+SG
norme	normer	Ver:IPre+SG+P1:IPre+SG+P3:SPre+SG+P1:SPre+SG+P3:ImPre+SG+P2
normés	normé	Adj:Mas+PL
normes	norme	Nom:Fem+PL
normes	normer	Ver:IPre+SG+P2:SPre+SG+P2
normés	normer	Ver:PPas+Mas+PL
normoblaste	normoblaste	Nom:Mas+SG
normographe	normographe	Nom:Mas+SG
norois	norois	Nom:Mas+InvPL
noroît	noroît	Nom:Mas+SG
noroîts	noroît	Nom:Mas+PL
norrois	norrois	Adj:Mas+InvPL
norrois	norrois	Nom:Mas+InvPL
norvégienne	norvégien	Adj:Fem+SG
norvégienne	norvégienne	Nom:Fem+SG
norvégienne	norvégien	Nom:Fem+SG
norvégiennes	norvégien	Adj:Fem+PL
norvégiennes	norvégienne	Nom:Fem+PL
norvégiennes	norvégien	Nom:Fem+PL
norvégien	norvégien	Adj:Mas+SG
norvégiens	norvégien	Adj:Mas+PL
nosémose	nosémose	Nom:Fem+SG
nosémoses	nosémose	Nom:Fem+PL
nos	notre	Det:InvGen+PL
nosographie	nosographie	Nom:Fem+SG
nosographies	nosographie	Nom:Fem+PL
nosographique	nosographique	Adj:InvGen+SG
nosologie	nosologie	Nom:Fem+SG
nosologies	nosologie	Nom:Fem+PL
nosologique	nosologique	Adj:InvGen+SG
nosologiste	nosologiste	Nom:InvGen+SG
nostalgie	nostalgie	Nom:Fem+SG
nostalgies	nostalgie	Nom:Fem+PL
nostalgiquement	nostalgiquement	Adv
nostalgique	nostalgique	Adj:InvGen+SG
nostalgique	nostalgique	Nom:InvGen+SG
nostalgiques	nostalgique	Adj:InvGen+PL
nostalgiques	nostalgique	Nom:InvGen+PL
nostoc	nostoc	Nom:Mas+SG
nostocs	nostoc	Nom:Mas+PL
nostomanie	nostomanie	Nom:Fem+SG
notabilité	notabilité	Nom:Fem+SG
notabilités	notabilité	Nom:Fem+PL
notablement	notablement	Adv
notable	notable	Adj:InvGen+SG
notables	notable	Adj:InvGen+PL
notaient	noter	Ver:IImp+PL+P3
notai	noter	Ver:IPSim+SG+P1
notaire	notaire	Nom:Mas+SG
notaires	notaire	Nom:Mas+PL
notairesse	notairesse	Nom:Fem+SG
notais	noter	Ver:IImp+SG+P1:IImp+SG+P2
notait	noter	Ver:IImp+SG+P3
notâmes	noter	Ver:IPSim+PL+P1
notamment	notamment	Adv
nota	nota	Nom:Mas+InvPL
nota	noter	Ver:IPSim+SG+P3
notant	noter	Ver:PPre
notarial	notarial	Adj:Mas+SG
notariat	notariat	Nom:Mas+SG
notariats	notariat	Nom:Mas+PL
notariaux	notarial	Adj:Mas+PL
notariée	notarié	Adj:Fem+SG
notariées	notarié	Adj:Fem+PL
notariées	notarier	Ver:PPas+Fem+PL
notarié	notarié	Adj:Mas+SG
notariés	notarié	Adj:Mas+PL
notas	noter	Ver:IPSim+SG+P2
notasse	noter	Ver:SImp+SG+P1
notassent	noter	Ver:SImp+PL+P3
notasses	noter	Ver:SImp+SG+P2
notassiez	noter	Ver:SImp+PL+P2
notassions	noter	Ver:SImp+PL+P1
notâtes	noter	Ver:IPSim+PL+P2
notateur	notateur	Nom:Mas+SG
notation	notation	Nom:Fem+SG
notations	notation	Nom:Fem+PL
notât	noter	Ver:SImp+SG+P3
notée	noter	Ver:PPas+Fem+SG
notées	noter	Ver:PPas+Fem+PL
note	note	Nom:Fem+SG
note	noter	Ver:IPre+SG+P1:IPre+SG+P3:SPre+SG+P1:SPre+SG+P3:ImPre+SG+P2
noté	noter	Ver:PPas+Mas+SG
notent	noter	Ver:IPre+PL+P3:SPre+PL+P3
noteraient	noter	Ver:CPre+PL+P3
noterai	noter	Ver:IFut+SG+P1
noterais	noter	Ver:CPre+SG+P1:CPre+SG+P2
noterait	noter	Ver:CPre+SG+P3
notera	noter	Ver:IFut+SG+P3
noteras	noter	Ver:IFut+SG+P2
notèrent	noter	Ver:IPSim+PL+P3
noterez	noter	Ver:IFut+PL+P2
noteriez	noter	Ver:CPre+PL+P2
noterions	noter	Ver:CPre+PL+P1
noter	noter	Ver:Inf
noterons	noter	Ver:IFut+PL+P1
noteront	noter	Ver:IFut+PL+P3
notes	note	Nom:Fem+PL
notes	noter	Ver:IPre+SG+P2:SPre+SG+P2
notés	noter	Ver:PPas+Mas+PL
notes	notes	Nom:Fem+PL
notez	noter	Ver:IPre+PL+P2:ImPre+PL+P2
notice	notice	Nom:Fem+SG
notices	notice	Nom:Fem+PL
notiez	noter	Ver:IImp+PL+P2:SPre+PL+P2
notifiaient	notifier	Ver:IImp+PL+P3
notifiai	notifier	Ver:IPSim+SG+P1
notifiais	notifier	Ver:IImp+SG+P1:IImp+SG+P2
notifiait	notifier	Ver:IImp+SG+P3
notifiâmes	notifier	Ver:IPSim+PL+P1
notifia	notifier	Ver:IPSim+SG+P3
notifiant	notifier	Ver:PPre
notifias	notifier	Ver:IPSim+SG+P2
notifiasse	notifier	Ver:SImp+SG+P1
notifiassent	notifier	Ver:SImp+PL+P3
notifiasses	notifier	Ver:SImp+SG+P2
notifiassiez	notifier	Ver:SImp+PL+P2
notifiassions	notifier	Ver:SImp+PL+P1
notifiâtes	notifier	Ver:IPSim+PL+P2
notifiât	notifier	Ver:SImp+SG+P3
notification	notification	Nom:Fem+SG
notifications	notification	Nom:Fem+PL
notifiée	notifier	Ver:PPas+Fem+SG
notifiées	notifier	Ver:PPas+Fem+PL
notifie	notifier	Ver:IPre+SG+P1:IPre+SG+P3:SPre+SG+P1:SPre+SG+P3:ImPre+SG+P2
notifié	notifier	Ver:PPas+Mas+SG
notifient	notifier	Ver:IPre+PL+P3:SPre+PL+P3
notifieraient	notifier	Ver:CPre+PL+P3
notifierai	notifier	Ver:IFut+SG+P1
notifierais	notifier	Ver:CPre+SG+P1:CPre+SG+P2
notifierait	notifier	Ver:CPre+SG+P3
notifiera	notifier	Ver:IFut+SG+P3
notifieras	notifier	Ver:IFut+SG+P2
notifièrent	notifier	Ver:IPSim+PL+P3
notifierez	notifier	Ver:IFut+PL+P2
notifieriez	notifier	Ver:CPre+PL+P2
notifierions	notifier	Ver:CPre+PL+P1
notifier	notifier	Ver:Inf
notifierons	notifier	Ver:IFut+PL+P1
notifieront	notifier	Ver:IFut+PL+P3
notifies	notifier	Ver:IPre+SG+P2:SPre+SG+P2
notifiés	notifier	Ver:PPas+Mas+PL
notifiez	notifier	Ver:IPre+PL+P2:ImPre+PL+P2
notifiiez	notifier	Ver:IImp+PL+P2:SPre+PL+P2
notifiions	notifier	Ver:IImp+PL+P1:SPre+PL+P1
notifions	notifier	Ver:IPre+PL+P1:ImPre+PL+P1
notionnelle	notionnel	Adj:Fem+SG
notionnelles	notionnel	Adj:Fem+PL
notionnel	notionnel	Adj:Mas+SG
notion	notion	Nom:Fem+SG
notions	noter	Ver:IImp+PL+P1:SPre+PL+P1
notions	notion	Nom:Fem+PL
notoirement	notoirement	Adv
notoire	notoire	Adj:InvGen+SG
notoires	notoire	Adj:InvGen+PL
notonecte	notonecte	Nom:Fem+SG
notons	noter	Ver:IPre+PL+P1:ImPre+PL+P1
notoriété	notoriété	Nom:Fem+SG
notoriétés	notoriété	Nom:Fem+PL
nôtre	nôtre	Adj:InvGen+SG
notre	notre	Det:InvGen+SG
nôtre	nôtre	Nom:Mas+SG
nôtre	nôtre	Pro:InvGen+SG
nôtres	nôtre	Adj:InvGen+PL
nôtres	nôtre	Pro:InvGen+PL
nôtres	nôtres	Nom:Mas+PL
notre-dame	notre-dame	Nom:Fem+InvPL
notule	notule	Nom:Fem+SG
notules	notule	Nom:Fem+PL
nouage	nouage	Nom:Mas+SG
nouages	nouage	Nom:Mas+PL
nouaient	nouer	Ver:IImp+PL+P3
nouai	nouer	Ver:IPSim+SG+P1
nouais	nouer	Ver:IImp+SG+P1:IImp+SG+P2
nouaison	nouaison	Nom:Fem+SG
nouait	nouer	Ver:IImp+SG+P3
nouâmes	nouer	Ver:IPSim+PL+P1
noua	nouer	Ver:IPSim+SG+P3
nouant	nouer	Ver:PPre
nouas	nouer	Ver:IPSim+SG+P2
nouasse	nouer	Ver:SImp+SG+P1
nouassent	nouer	Ver:SImp+PL+P3
nouasses	nouer	Ver:SImp+SG+P2
nouassiez	nouer	Ver:SImp+PL+P2
nouassions	nouer	Ver:SImp+PL+P1
nouâtes	nouer	Ver:IPSim+PL+P2
nouât	nouer	Ver:SImp+SG+P3
nouba	nouba	Nom:Fem+SG
nouée	noué	Adj:Fem+SG
nouée	nouer	Ver:PPas+Fem+SG
nouées	noué	Adj:Fem+PL
nouées	nouer	Ver:PPas+Fem+PL
noué	noué	Adj:Mas+SG
noue	noue	Nom:Fem+SG
noue	nouer	Ver:IPre+SG+P1:IPre+SG+P3:SPre+SG+P1:SPre+SG+P3:ImPre+SG+P2
noué	nouer	Ver:PPas+Mas+SG
nouent	nouer	Ver:IPre+PL+P3:SPre+PL+P3
noueraient	nouer	Ver:CPre+PL+P3
nouerai	nouer	Ver:IFut+SG+P1
nouerais	nouer	Ver:CPre+SG+P1:CPre+SG+P2
nouerait	nouer	Ver:CPre+SG+P3
nouera	nouer	Ver:IFut+SG+P3
noueras	nouer	Ver:IFut+SG+P2
nouèrent	nouer	Ver:IPSim+PL+P3
nouerez	nouer	Ver:IFut+PL+P2
noueriez	nouer	Ver:CPre+PL+P2
nouerions	nouer	Ver:CPre+PL+P1
nouer	nouer	Ver:Inf
nouerons	nouer	Ver:IFut+PL+P1
noueront	nouer	Ver:IFut+PL+P3
noués	noué	Adj:Mas+PL
noues	noue	Nom:Fem+PL
noues	nouer	Ver:IPre+SG+P2:SPre+SG+P2
noués	nouer	Ver:PPas+Mas+PL
noues	noues	Nom:Fem+PL
noueuse	noueux	Adj:Fem+SG
noueuses	noueux	Adj:Fem+PL
noueux	noueux	Adj:Mas+InvPL
nouez	nouer	Ver:IPre+PL+P2:ImPre+PL+P2
nougatine	nougatine	Nom:Fem+SG
nougatines	nougatine	Nom:Fem+PL
nougat	nougat	Nom:Mas+SG
nougats	nougat	Nom:Mas+PL
nougats	nougats	Nom:Mas+PL
nouiez	nouer	Ver:IImp+PL+P2:SPre+PL+P2
nouille	nouille	Nom:Fem+SG
nouilles	nouille	Nom:Fem+PL
nouilles	nouilles	Nom:Fem+PL
nouions	nouer	Ver:IImp+PL+P1:SPre+PL+P1
noulet	noulet	Nom:Mas+SG
noulets	noulet	Nom:Mas+PL
noumène	noumène	Nom:Mas+SG
nounou	nounou	Nom:Fem+SG
nouons	nouer	Ver:IPre+PL+P1:ImPre+PL+P1
nourrain	nourrain	Nom:Mas+SG
nourrains	nourrain	Nom:Mas+PL
nourrice	nourrice	Nom:Fem+SG
nourricerie	nourricerie	Nom:Fem+SG
nourrices	nourrice	Nom:Fem+PL
nourricière	nourricier	Adj:Fem+SG
nourricières	nourricier	Adj:Fem+PL
nourricier	nourricier	Adj:Mas+SG
nourriciers	nourricier	Adj:Mas+PL
nourrie	nourri	Adj:Fem+SG
nourrie	nourrir	Ver:PPas+Fem+SG
nourries	nourri	Adj:Fem+PL
nourries	nourrir	Ver:PPas+Fem+PL
nourrîmes	nourrir	Ver:IPSim+PL+P1
nourri	nourri	Adj:Mas+SG
nourri	nourrir	Ver:PPas+Mas+SG
nourriraient	nourrir	Ver:CPre+PL+P3
nourrirai	nourrir	Ver:IFut+SG+P1
nourrirais	nourrir	Ver:CPre+SG+P1:CPre+SG+P2
nourrirait	nourrir	Ver:CPre+SG+P3
nourrira	nourrir	Ver:IFut+SG+P3
nourriras	nourrir	Ver:IFut+SG+P2
nourrirent	nourrir	Ver:IPSim+PL+P3
nourrirez	nourrir	Ver:IFut+PL+P2
nourririez	nourrir	Ver:CPre+PL+P2
nourririons	nourrir	Ver:CPre+PL+P1
nourrir	nourrir	Ver:Inf
nourrirons	nourrir	Ver:IFut+PL+P1
nourriront	nourrir	Ver:IFut+PL+P3
nourris	nourri	Adj:Mas+PL
nourris	nourrir	Ver:PPas+Mas+PL:IPre+SG+P1:IPre+SG+P2:IPSim+SG+P1:IPSim+SG+P2:ImPre+SG+P2
nourrissage	nourrissage	Nom:Mas+SG
nourrissages	nourrissage	Nom:Mas+PL
nourrissaient	nourrir	Ver:IImp+PL+P3
nourrissais	nourrir	Ver:IImp+SG+P1:IImp+SG+P2
nourrissait	nourrir	Ver:IImp+SG+P3
nourrissante	nourrissant	Adj:Fem+SG
nourrissantes	nourrissant	Adj:Fem+PL
nourrissant	nourrir	Ver:PPre
nourrissant	nourrir	Ver:PPre
nourrissant	nourrir	Ver:PPre+Mas+SG
nourrissant	nourrissant	Adj:Mas+SG
nourrissant	nourrissant	Adj:Mas+SG
nourrissants	nourrissant	Adj:Mas+PL
nourrisse	nourrir	Ver:SPre+SG+P1:SPre+SG+P3:SImp+SG+P1
nourrissent	nourrir	Ver:IPre+PL+P3:SPre+PL+P3:SImp+PL+P3
nourrisses	nourrir	Ver:SPre+SG+P2:SImp+SG+P2
nourrisseur	nourrisseur	Nom:Mas+SG
nourrisseurs	nourrisseur	Nom:Mas+PL
nourrissez	nourrir	Ver:IPre+PL+P2:ImPre+PL+P2
nourrissiez	nourrir	Ver:IImp+PL+P2:SPre+PL+P2:SImp+PL+P2
nourrissions	nourrir	Ver:IImp+PL+P1:SPre+PL+P1:SImp+PL+P1
nourrisson	nourrisson	Nom:Mas+SG
nourrissons	nourrir	Ver:IPre+PL+P1:ImPre+PL+P1
nourrissons	nourrisson	Nom:Mas+PL
nourrîtes	nourrir	Ver:IPSim+PL+P2
nourrit	nourrir	Ver:IPre+SG+P3:IPSim+SG+P3
nourrît	nourrir	Ver:SImp+SG+P3
nourriture	nourriture	Nom:Fem+SG
nourritures	nourriture	Nom:Fem+PL
nous	nous	Pro:PL+P1
nous-mêmes	nous	InvGen+PL+P1+PProRefl
nouure	nouure	Nom:Fem+SG
nouveau	nouveau	Adj:Mas+SG
nouveau	nouveau	Nom:Mas+SG
nouveauté	nouveauté	Nom:Fem+SG
nouveautés	nouveauté	Nom:Fem+PL
nouveaux	nouveau	Adj:Mas+PL
nouveaux	nouveau	Nom:Mas+PL
nouveau-née	nouveau-né	Adj:Fem+SG
nouveau-née	nouveau-né	Nom:Fem+SG
nouveau-nées	nouveau-né	Adj:Fem+PL
nouveau-nées	nouveau-né	Nom:Fem+PL
nouveau-né	nouveau-né	Adj:Mas+SG
nouveau-né	nouveau-né	Nom:Mas+SG
nouveau-nés	nouveau-né	Adj:Mas+PL
nouveau-nés	nouveau-né	Nom:Mas+PL
nouvellement	nouvellement	Adv
nouvelle	nouveau	Adj:Fem+SG
nouvelle	nouveau	Nom:Fem+SG
nouvelle	nouvelle	Nom:Fem+SG
nouvelles	nouveau	Adj:Fem+PL
nouvelles	nouveau	Nom:Fem+PL
nouvelles	nouvelle	Nom:Fem+PL
nouvelles	nouvelles	Nom:Fem+PL
nouvelliste	nouvelliste	Nom:InvGen+SG
nouvel	nouvel	Adj:Mas+SG
novaient	nover	Ver:IImp+PL+P3
novai	nover	Ver:IPSim+SG+P1
novais	nover	Ver:IImp+SG+P1:IImp+SG+P2
novait	nover	Ver:IImp+SG+P3
novâmes	nover	Ver:IPSim+PL+P1
nova	nova	Nom:Fem+SG
nova	nover	Ver:IPSim+SG+P3
novant	nover	Ver:PPre
novas	nova	Nom:Fem+PL
novas	nover	Ver:IPSim+SG+P2
novasse	nover	Ver:SImp+SG+P1
novassent	nover	Ver:SImp+PL+P3
novasses	nover	Ver:SImp+SG+P2
novassiez	nover	Ver:SImp+PL+P2
novassions	nover	Ver:SImp+PL+P1
novâtes	nover	Ver:IPSim+PL+P2
novateur	novateur	Adj:Mas+SG
novateurs	novateur	Adj:Mas+PL
novation	novation	Nom:Fem+SG
novations	novation	Nom:Fem+PL
novât	nover	Ver:SImp+SG+P3
novatoire	novatoire	Adj:InvGen+SG
novatoires	novatoire	Adj:InvGen+PL
novatrice	novateur	Adj:Fem+SG
novatrice	novateur	Nom:Fem+SG
novatrices	novateur	Adj:Fem+PL
novatrices	novateur	Nom:Fem+PL
novée	nover	Ver:PPas+Fem+SG
novées	nover	Ver:PPas+Fem+PL
novembre	novembre	Nom:Mas+SG
novembres	novembre	Nom:Mas+PL
nove	nover	Ver:IPre+SG+P1:IPre+SG+P3:SPre+SG+P1:SPre+SG+P3:ImPre+SG+P2
nové	nover	Ver:PPas+Mas+SG
novent	nover	Ver:IPre+PL+P3:SPre+PL+P3
noveraient	nover	Ver:CPre+PL+P3
noverai	nover	Ver:IFut+SG+P1
noverais	nover	Ver:CPre+SG+P1:CPre+SG+P2
noverait	nover	Ver:CPre+SG+P3
novera	nover	Ver:IFut+SG+P3
noveras	nover	Ver:IFut+SG+P2
novèrent	nover	Ver:IPSim+PL+P3
noverez	nover	Ver:IFut+PL+P2
noveriez	nover	Ver:CPre+PL+P2
noverions	nover	Ver:CPre+PL+P1
nover	nover	Ver:Inf
noverons	nover	Ver:IFut+PL+P1
noveront	nover	Ver:IFut+PL+P3
noves	nover	Ver:IPre+SG+P2:SPre+SG+P2
novés	nover	Ver:PPas+Mas+PL
novez	nover	Ver:IPre+PL+P2:ImPre+PL+P2
novice	novice	Adj:InvGen+SG
novice	novice	Nom:InvGen+SG
novices	novice	Adj:InvGen+PL
novices	novice	Nom:InvGen+PL
noviciat	noviciat	Nom:Mas+SG
noviciats	noviciat	Nom:Mas+PL
noviez	nover	Ver:IImp+PL+P2:SPre+PL+P2
novions	nover	Ver:IImp+PL+P1:SPre+PL+P1
nov	nov	Abr
novocaïne	novocaïne	Nom:Fem+SG
novons	nover	Ver:IPre+PL+P1:ImPre+PL+P1
noyade	noyade	Nom:Fem+SG
noyades	noyade	Nom:Fem+PL
noyaient	noyer	Ver:IImp+PL+P3
noyai	noyer	Ver:IPSim+SG+P1
noyais	noyer	Ver:IImp+SG+P1:IImp+SG+P2
noyait	noyer	Ver:IImp+SG+P3
noyâmes	noyer	Ver:IPSim+PL+P1
noya	noyer	Ver:IPSim+SG+P3
noyant	noyer	Ver:PPre
noyas	noyer	Ver:IPSim+SG+P2
noyasse	noyer	Ver:SImp+SG+P1
noyassent	noyer	Ver:SImp+PL+P3
noyasses	noyer	Ver:SImp+SG+P2
noyassiez	noyer	Ver:SImp+PL+P2
noyassions	noyer	Ver:SImp+PL+P1
noyâtes	noyer	Ver:IPSim+PL+P2
noyât	noyer	Ver:SImp+SG+P3
noyau	noyau	Nom:Mas+SG
noyautage	noyautage	Nom:Mas+SG
noyautages	noyautage	Nom:Mas+PL
noyautaient	noyauter	Ver:IImp+PL+P3
noyautai	noyauter	Ver:IPSim+SG+P1
noyautais	noyauter	Ver:IImp+SG+P1:IImp+SG+P2
noyautait	noyauter	Ver:IImp+SG+P3
noyautâmes	noyauter	Ver:IPSim+PL+P1
noyauta	noyauter	Ver:IPSim+SG+P3
noyautant	noyauter	Ver:PPre
noyautas	noyauter	Ver:IPSim+SG+P2
noyautasse	noyauter	Ver:SImp+SG+P1
noyautassent	noyauter	Ver:SImp+PL+P3
noyautasses	noyauter	Ver:SImp+SG+P2
noyautassiez	noyauter	Ver:SImp+PL+P2
noyautassions	noyauter	Ver:SImp+PL+P1
noyautâtes	noyauter	Ver:IPSim+PL+P2
noyautât	noyauter	Ver:SImp+SG+P3
noyautée	noyauter	Ver:PPas+Fem+SG
noyautées	noyauter	Ver:PPas+Fem+PL
noyaute	noyauter	Ver:IPre+SG+P1:IPre+SG+P3:SPre+SG+P1:SPre+SG+P3:ImPre+SG+P2
noyauté	noyauter	Ver:PPas+Mas+SG
noyautent	noyauter	Ver:IPre+PL+P3:SPre+PL+P3
noyauteraient	noyauter	Ver:CPre+PL+P3
noyauterai	noyauter	Ver:IFut+SG+P1
noyauterais	noyauter	Ver:CPre+SG+P1:CPre+SG+P2
noyauterait	noyauter	Ver:CPre+SG+P3
noyautera	noyauter	Ver:IFut+SG+P3
noyauteras	noyauter	Ver:IFut+SG+P2
noyautèrent	noyauter	Ver:IPSim+PL+P3
noyauterez	noyauter	Ver:IFut+PL+P2
noyauteriez	noyauter	Ver:CPre+PL+P2
noyauterions	noyauter	Ver:CPre+PL+P1
noyauter	noyauter	Ver:Inf
noyauterons	noyauter	Ver:IFut+PL+P1
noyauteront	noyauter	Ver:IFut+PL+P3
noyautes	noyauter	Ver:IPre+SG+P2:SPre+SG+P2
noyautés	noyauter	Ver:PPas+Mas+PL
noyautez	noyauter	Ver:IPre+PL+P2:ImPre+PL+P2
noyautiez	noyauter	Ver:IImp+PL+P2:SPre+PL+P2
noyautions	noyauter	Ver:IImp+PL+P1:SPre+PL+P1
noyautons	noyauter	Ver:IPre+PL+P1:ImPre+PL+P1
noyaux	noyau	Nom:Mas+PL
noyée	noyé	Adj:Fem+SG
noyée	noyé	Nom:Fem+SG
noyée	noyer	Ver:PPas+Fem+SG
noyées	noyé	Adj:Fem+PL
noyées	noyé	Nom:Fem+PL
noyées	noyer	Ver:PPas+Fem+PL
noyé	noyé	Adj:Mas+SG
noyé	noyé	Nom:Mas+SG
noyé	noyer	Ver:PPas+Mas+SG
noyèrent	noyer	Ver:IPSim+PL+P3
noyer	noyer	Nom:Mas+SG
noyer	noyer	Ver:Inf
noyers	noyer	Nom:Mas+PL
noyés	noyé	Adj:Mas+PL
noyés	noyé	Nom:Mas+PL
noyés	noyer	Ver:PPas+Mas+PL
noyez	noyer	Ver:IPre+PL+P2:ImPre+PL+P2
noyiez	noyer	Ver:IImp+PL+P2:SPre+PL+P2
noyions	noyer	Ver:IImp+PL+P1:SPre+PL+P1
noyons	noyer	Ver:IPre+PL+P1:ImPre+PL+P1
nuage	nuage	Nom:Mas+SG
nuage	nuager	Ver:IPre+SG+P1:IPre+SG+P3:SPre+SG+P1:SPre+SG+P3:ImPre+SG+P2
nuages	nuage	Nom:Mas+PL
nuages	nuager	Ver:IPre+SG+P2:SPre+SG+P2
nuageuse	nuageux	Adj:Fem+SG
nuageuses	nuageux	Adj:Fem+PL
nuageux	nuageux	Adj:Mas+InvPL
nuaient	nuer	Ver:IImp+PL+P3
nuai	nuer	Ver:IPSim+SG+P1
nuais	nuer	Ver:IImp+SG+P1:IImp+SG+P2
nuait	nuer	Ver:IImp+SG+P3
nuâmes	nuer	Ver:IPSim+PL+P1
nuançaient	nuancer	Ver:IImp+PL+P3
nuançai	nuancer	Ver:IPSim+SG+P1
nuançais	nuancer	Ver:IImp+SG+P1:IImp+SG+P2
nuançait	nuancer	Ver:IImp+SG+P3
nuançâmes	nuancer	Ver:IPSim+PL+P1
nuançant	nuancer	Ver:PPre
nuançants	nuancer	Ver:PPre+Mas+PL
nuança	nuancer	Ver:IPSim+SG+P3
nuanças	nuancer	Ver:IPSim+SG+P2
nuançassent	nuancer	Ver:SImp+PL+P3
nuançasse	nuancer	Ver:SImp+SG+P1
nuançasses	nuancer	Ver:SImp+SG+P2
nuançassiez	nuancer	Ver:SImp+PL+P2
nuançassions	nuancer	Ver:SImp+PL+P1
nuançâtes	nuancer	Ver:IPSim+PL+P2
nuançât	nuancer	Ver:SImp+SG+P3
nuancée	nuancé	Adj:Fem+SG
nuancée	nuancer	Ver:PPas+Fem+SG
nuancées	nuancé	Adj:Fem+PL
nuancées	nuancer	Ver:PPas+Fem+PL
nuancent	nuancer	Ver:IPre+PL+P3:SPre+PL+P3
nuancé	nuancé	Adj:Mas+SG
nuance	nuance	Nom:Fem+SG
nuance	nuancer	Ver:IPre+SG+P1:IPre+SG+P3:SPre+SG+P1:SPre+SG+P3:ImPre+SG+P2
nuancé	nuancer	Ver:PPas+Mas+SG
nuanceraient	nuancer	Ver:CPre+PL+P3
nuancerai	nuancer	Ver:IFut+SG+P1
nuancerais	nuancer	Ver:CPre+SG+P1:CPre+SG+P2
nuancerait	nuancer	Ver:CPre+SG+P3
nuancera	nuancer	Ver:IFut+SG+P3
nuanceras	nuancer	Ver:IFut+SG+P2
nuancèrent	nuancer	Ver:IPSim+PL+P3
nuancerez	nuancer	Ver:IFut+PL+P2
nuanceriez	nuancer	Ver:CPre+PL+P2
nuancerions	nuancer	Ver:CPre+PL+P1
nuancer	nuancer	Ver:Inf
nuancerons	nuancer	Ver:IFut+PL+P1
nuanceront	nuancer	Ver:IFut+PL+P3
nuancés	nuancé	Adj:Mas+PL
nuances	nuance	Nom:Fem+PL
nuances	nuancer	Ver:IPre+SG+P2:SPre+SG+P2
nuancés	nuancer	Ver:PPas+Mas+PL
nuancez	nuancer	Ver:IPre+PL+P2:ImPre+PL+P2
nuanciez	nuancer	Ver:IImp+PL+P2:SPre+PL+P2
nuancions	nuancer	Ver:IImp+PL+P1:SPre+PL+P1
nuançons	nuancer	Ver:IPre+PL+P1:ImPre+PL+P1
nuant	nuer	Ver:PPre
nua	nuer	Ver:IPSim+SG+P3
nuas	nuer	Ver:IPSim+SG+P2
nuassent	nuer	Ver:SImp+PL+P3
nuasse	nuer	Ver:SImp+SG+P1
nuasses	nuer	Ver:SImp+SG+P2
nuassiez	nuer	Ver:SImp+PL+P2
nuassions	nuer	Ver:SImp+PL+P1
nuâtes	nuer	Ver:IPSim+PL+P2
nuât	nuer	Ver:SImp+SG+P3
nubienne	nubien	Adj:Fem+SG
nubien	nubien	Adj:Mas+SG
nubile	nubile	Adj:InvGen+SG
nubiles	nubile	Adj:InvGen+PL
nubilité	nubilité	Nom:Fem+SG
nucelle	nucelle	Nom:Mas+SG
nucelles	nucelle	Nom:Mas+PL
nucléaire	nucléaire	Adj:InvGen+SG
nucléaire	nucléaire	Nom:Mas+SG
nucléaires	nucléaire	Adj:InvGen+PL
nucléaires	nucléaire	Nom:Mas+PL
nucléariser	nucléariser	Ver:Inf
nucléée	nucléé	Adj:Fem+SG
nucléées	nucléé	Adj:Fem+PL
nucléé	nucléé	Adj:Mas+SG
nucléés	nucléé	Adj:Mas+PL
nucléine	nucléine	Nom:Fem+SG
nucléique	nucléique	Adj:InvGen+SG
nucléiques	nucléique	Adj:InvGen+PL
nucléole	nucléole	Nom:Mas+SG
nucléonique	nucléonique	Adj:InvGen+SG
nucléonique	nucléonique	Nom:Fem+SG
nucléoniques	nucléonique	Adj:InvGen+PL
nucléoniques	nucléonique	Nom:Fem+PL
nucléon	nucléon	Nom:Mas+SG
nucléoprotéine	nucléoprotéine	Nom:Fem+SG
nucléoprotéines	nucléoprotéine	Nom:Fem+PL
nucléosynthèse	nucléosynthèse	Nom:Fem+SG
nucléotide	nucléotide	Nom:Mas+SG
nucléus	nucléus	Nom:Mas+InvPL
nudisme	nudisme	Nom:Mas+SG
nudiste	nudiste	Adj:InvGen+SG
nudiste	nudiste	Nom:InvGen+SG
nudistes	nudiste	Adj:InvGen+PL
nudistes	nudiste	Nom:InvGen+PL
nudité	nudité	Nom:Fem+SG
nudités	nudité	Nom:Fem+PL
nuée	nué	Adj:Fem+SG
nuée	nuée	Nom:Fem+SG
nuée	nuer	Ver:PPas+Fem+SG
nuées	nué	Adj:Fem+PL
nuées	nuée	Nom:Fem+PL
nuées	nuées	Nom:Fem+PL
nuées	nuer	Ver:PPas+Fem+PL
nuent	nuer	Ver:IPre+PL+P3:SPre+PL+P3
nue	nu	Adj:Fem+SG
nué	nué	Adj:Mas+SG
nue	nue	Nom:Fem+SG
nue	nuer	Ver:IPre+SG+P1:IPre+SG+P3:SPre+SG+P1:SPre+SG+P3:ImPre+SG+P2
nuèrent	nuer	Ver:IPSim+PL+P3
nuer	nuer	Ver:Inf
nues	nu	Adj:Fem+PL
nues	nue	Nom:Fem+PL
nues	nuer	Ver:IPre+SG+P2:SPre+SG+P2
nues	nues	Nom:Fem+PL
nues-propriétaires	nu-propriétaire	Nom:Fem+PL
nues-propriétés	nue-propriété	Nom:Fem+PL
nuez	nuer	Ver:IPre+PL+P2:ImPre+PL+P2
nue-propriétaire	nu-propriétaire	Nom:Fem+SG
nue-propriété	nue-propriété	Nom:Fem+SG
nuiez	nuer	Ver:IImp+PL+P2:SPre+PL+P2
nui	nuire	Ver:PPas+Mas+SG
nuions	nuer	Ver:IImp+PL+P1:SPre+PL+P1
nuiraient	nuire	Ver:CPre+PL+P3
nuirai	nuire	Ver:IFut+SG+P1
nuirais	nuire	Ver:CPre+SG+P1:CPre+SG+P2
nuirait	nuire	Ver:CPre+SG+P3
nuira	nuire	Ver:IFut+SG+P3
nuiras	nuire	Ver:IFut+SG+P2
nuire	nuire	Ver:Inf
nuirez	nuire	Ver:IFut+PL+P2
nuiriez	nuire	Ver:CPre+PL+P2
nuirions	nuire	Ver:CPre+PL+P1
nuirons	nuire	Ver:IFut+PL+P1
nuiront	nuire	Ver:IFut+PL+P3
nuisaient	nuire	Ver:IImp+PL+P3
nuisais	nuire	Ver:IImp+SG+P1:IImp+SG+P2
nuisait	nuire	Ver:IImp+SG+P3
nuisance	nuisance	Nom:Fem+SG
nuisances	nuisance	Nom:Fem+PL
nuisant	nuire	Ver:PPre
nuisent	nuire	Ver:IPre+PL+P3:SPre+PL+P3
nuise	nuire	Ver:SPre+SG+P1:SPre+SG+P3
nuises	nuire	Ver:SPre+SG+P2
nuisez	nuire	Ver:IPre+PL+P2:ImPre+PL+P2
nuisiblement	nuisiblement	Adv
nuisible	nuisible	Adj:InvGen+SG
nuisible	nuisible	Nom:Mas+SG
nuisibles	nuisible	Adj:InvGen+PL
nuisibles	nuisible	Nom:Mas+PL
nuisiez	nuire	Ver:IImp+PL+P2:SPre+PL+P2
nuisîmes	nuire	Ver:IPSim+PL+P1
nuisions	nuire	Ver:IImp+PL+P1:SPre+PL+P1
nuisirent	nuire	Ver:IPSim+PL+P3
nuisis	nuire	Ver:IPSim+SG+P1:IPSim+SG+P2
nuisisse	nuire	Ver:SImp+SG+P1
nuisisses	nuire	Ver:SImp+SG+P2
nuisissiez	nuire	Ver:SImp+PL+P2
nuisissions	nuire	Ver:SImp+PL+P1
nuisîtes	nuire	Ver:IPSim+PL+P2
nuisit	nuire	Ver:IPSim+SG+P3
nuisît	nuire	Ver:SImp+SG+P3
nuis	nuire	Ver:IPre+SG+P1:IPre+SG+P2:ImPre+SG+P2
nuis	nuire	Ver:IPSim+SG+P1:IPSim+SG+P2
nuisons	nuire	Ver:IPre+PL+P1:ImPre+PL+P1
nuitamment	nuitamment	Adv
nuitée	nuitée	Nom:Fem+SG
nuitée	nuiter	Ver:PPas+Fem+SG
nuitées	nuitée	Nom:Fem+PL
nuitées	nuiter	Ver:PPas+Fem+PL
nuit	nuire	Ver:IPre+SG+P3
nuit	nuire	Ver:IPSim+SG+P3
nuit	nuit	Nom:Fem+SG
nuits	nuit	Nom:Fem+PL
nullarde	nullard	Adj:Fem+SG
nullarde	nullard	Nom:Fem+SG
nullardes	nullard	Adj:Fem+PL
nullardes	nullard	Nom:Fem+PL
nullard	nullard	Adj:Mas+SG
nullard	nullard	Nom:Mas+SG
nullards	nullard	Adj:Mas+PL
nullards	nullard	Nom:Mas+PL
nullement	nullement	Adv
nulle	nul	Adj:Fem+SG
nulle	nul	Det:Fem+SG
nulle	nulle	Nom:Fem+SG
nulle	nul	Nom:Fem+SG
nulles	nul	Adj:Fem+PL
nulles	nul	Det:Fem+PL
nulles	nulle	Nom:Fem+PL
nulles	nul	Nom:Fem+PL
nullipare	nullipare	Adj:InvGen+SG
nullipare	nullipare	Nom:Fem+SG
nullité	nullité	Nom:Fem+SG
nullités	nullité	Nom:Fem+PL
nul	nul	Adj:Mas+SG
nul	nul	Det:Mas+SG
nul	nul	Nom:Mas+SG
nul	nul	Pro:Mas+SG
nuls	nul	Adj:Mas+PL
nuls	nul	Det:Mas+PL
nuls	nul	Nom:Mas+PL
nûment	nûment	Adv
numéraire	numéraire	Adj:InvGen+SG
numéraires	numéraire	Adj:InvGen+PL
numérale	numéral	Adj:Fem+SG
numérales	numéral	Adj:Fem+PL
numéral	numéral	Adj:Mas+SG
numérateur	numérateur	Adj:Mas+SG
numérateurs	numérateur	Adj:Mas+PL
numération	numération	Nom:Fem+SG
numérations	numération	Nom:Fem+PL
numéraux	numéral	Adj:Mas+PL
numéraux	numéral	Nom:Mas+PL
numériquement	numériquement	Adv
numérique	numérique	Adj:InvGen+SG
numériques	numérique	Adj:InvGen+PL
numérisation	numérisation	Nom:Fem+SG
numérisée	numériser	Ver:PPas+Fem+SG
numérisé	numériser	Ver:PPas
numérisé	numériser	Ver:PPas+Mas+SG
numériser	numériser	Ver:Inf
numériseur	numériseur	Nom:Mas+SG
numéro	numéro	Nom:Mas+SG
numéros	numéro	Nom:Mas+PL
numérotage	numérotage	Nom:Mas+SG
numérotages	numérotage	Nom:Mas+PL
numérotaient	numéroter	Ver:IImp+PL+P3
numérotai	numéroter	Ver:IPSim+SG+P1
numérotais	numéroter	Ver:IImp+SG+P1:IImp+SG+P2
numérotait	numéroter	Ver:IImp+SG+P3
numérotâmes	numéroter	Ver:IPSim+PL+P1
numérotant	numéroter	Ver:PPre
numérota	numéroter	Ver:IPSim+SG+P3
numérotas	numéroter	Ver:IPSim+SG+P2
numérotassent	numéroter	Ver:SImp+PL+P3
numérotasse	numéroter	Ver:SImp+SG+P1
numérotasses	numéroter	Ver:SImp+SG+P2
numérotassiez	numéroter	Ver:SImp+PL+P2
numérotassions	numéroter	Ver:SImp+PL+P1
numérotâtes	numéroter	Ver:IPSim+PL+P2
numérotation	numérotation	Nom:Fem+SG
numérotations	numérotation	Nom:Fem+PL
numérotât	numéroter	Ver:SImp+SG+P3
numérotée	numéroté	Adj:Fem+SG
numérotée	numéroter	Ver:PPas+Fem+SG
numérotées	numéroté	Adj:Fem+PL
numérotées	numéroter	Ver:PPas+Fem+PL
numérotent	numéroter	Ver:IPre+PL+P3:SPre+PL+P3
numéroté	numéroté	Adj:Mas+SG
numérote	numéroter	Ver:IPre+SG+P1:IPre+SG+P3:SPre+SG+P1:SPre+SG+P3:ImPre+SG+P2
numéroté	numéroter	Ver:PPas+Mas+SG
numéroteraient	numéroter	Ver:CPre+PL+P3
numéroterai	numéroter	Ver:IFut+SG+P1
numéroterais	numéroter	Ver:CPre+SG+P1:CPre+SG+P2
numéroterait	numéroter	Ver:CPre+SG+P3
numérotera	numéroter	Ver:IFut+SG+P3
numéroteras	numéroter	Ver:IFut+SG+P2
numérotèrent	numéroter	Ver:IPSim+PL+P3
numéroterez	numéroter	Ver:IFut+PL+P2
numéroteriez	numéroter	Ver:CPre+PL+P2
numéroterions	numéroter	Ver:CPre+PL+P1
numéroter	numéroter	Ver:Inf
numéroterons	numéroter	Ver:IFut+PL+P1
numéroteront	numéroter	Ver:IFut+PL+P3
numérotés	numéroté	Adj:Mas+PL
numérotes	numéroter	Ver:IPre+SG+P2:SPre+SG+P2
numérotés	numéroter	Ver:PPas+Mas+PL
numéroteur	numéroteur	Adj:Mas+SG
numéroteurs	numéroteur	Adj:Mas+PL
numérotez	numéroter	Ver:IPre+PL+P2:ImPre+PL+P2
numérotiez	numéroter	Ver:IImp+PL+P2:SPre+PL+P2
numérotions	numéroter	Ver:IImp+PL+P1:SPre+PL+P1
numérotons	numéroter	Ver:IPre+PL+P1:ImPre+PL+P1
numerus	numerus	Nom:Mas+InvPL
numide	numide	Adj:InvGen+SG
numide	numide	Nom:InvGen+SG
numides	numide	Adj:InvGen+PL
numides	numide	Nom:InvGen+PL
numismate	numismate	Nom:InvGen+SG
numismates	numismate	Nom:InvGen+PL
numismatique	numismatique	Adj:InvGen+SG
numismatique	numismatique	Nom:Fem+SG
numismatiques	numismatique	Adj:InvGen+PL
numismatiques	numismatique	Nom:Fem+PL
nummulite	nummulite	Nom:Fem+SG
nummulites	nummulite	Nom:Fem+PL
nummulitique	nummulitique	Adj:InvGen+SG
nummulitique	nummulitique	Nom:Mas+SG
nummulitiques	nummulitique	Adj:InvGen+PL
nummulitiques	nummulitique	Nom:Mas+PL
nunatak	nunatak	Nom:Mas+SG
nunataks	nunatak	Nom:Mas+PL
nuncupation	nuncupation	Nom:Fem+SG
nu	nu	Adj:Mas+SG
nu	nu	Nom:Mas+InvPL
nu	nu	Nom:Mas+SG
nuons	nuer	Ver:IPre+PL+P1:ImPre+PL+P1
nuptiale	nuptial	Adj:Fem+SG
nuptiales	nuptial	Adj:Fem+PL
nuptialité	nuptialité	Nom:Fem+SG
nuptial	nuptial	Adj:Mas+SG
nuptiaux	nuptial	Adj:Mas+PL
nuque	nuque	Nom:Fem+SG
nuques	nuque	Nom:Fem+PL
nuraghe	nuraghe	Nom:Mas+SG
nuraghi	nuraghe	Nom:Mas+PL
nurse	nurse	Nom:Fem+SG
nurseries	nursery	Nom:Fem+PL
nursery	nursery	Nom:Fem+SG
nurses	nurse	Nom:Fem+PL
nus	nu	Adj:Mas+PL
nus	nu	Nom:Mas+PL
nus-propriétaires	nu-propriétaire	Nom:Mas+PL
nutation	nutation	Nom:Fem+SG
nutriment	nutriment	Nom:Mas+SG
nutritif	nutritif	Adj:Mas+SG
nutritifs	nutritif	Adj:Mas+PL
nutritionnelle	nutritionnel	Adj:Fem+SG
nutritionnelles	nutritionnel	Adj:Fem+PL
nutritionnel	nutritionnel	Adj:Mas+SG
nutritionnels	nutritionnel	Adj:Mas+PL
nutritionniste	nutritionniste	Nom:InvGen+SG
nutrition	nutrition	Nom:Fem+SG
nutritive	nutritif	Adj:Fem+SG
nutritives	nutritif	Adj:Fem+PL
nu-pieds	nu-pieds	Nom:Mas+InvPL
nu-propriétaire	nu-propriétaire	Nom:Mas+SG
nyctaginacées	nyctaginacée	Nom:Fem+PL
nyctalope	nyctalope	Adj:InvGen+SG
nyctalope	nyctalope	Nom:InvGen+SG
nyctalopie	nyctalopie	Nom:Fem+SG
nycthéméral	nycthéméral	Adj:Mas+SG
nycthémère	nycthémère	Nom:Mas+SG
nycturie	nycturie	Nom:Fem+SG
nylon	nylon	Nom:Mas+SG
nymphale	nymphal	Adj:Fem+SG
nymphale	nymphale	Nom:Mas+SG
nymphales	nymphal	Adj:Fem+PL
nymphales	nymphale	Nom:Mas+PL
nymphalidé	nymphalidé	Nom:Mas+SG
nymphalidés	nymphalidé	Nom:Mas+PL
nymphal	nymphal	Adj:Mas+SG
nymphaux	nymphal	Adj:Mas+PL
nymphéacées	nymphéacée	Nom:Fem+PL
nymphéa	nymphéa	Nom:Mas+SG
nymphéas	nymphéa	Nom:Mas+PL
nymphée	nymphée	Nom:Mas+SG
nymphe	nymphe	Nom:Fem+SG
nymphes	nymphe	Nom:Fem+PL
nymphette	nymphette	Nom:Fem+SG
nymphomane	nymphomane	Adj:InvGen+SG
nymphomanes	nymphomane	Adj:InvGen+PL
nymphomanie	nymphomanie	Nom:Fem+SG
nymphose	nymphose	Nom:Fem+SG
nymphose	nymphoser	Ver:IPre+SG+P1:IPre+SG+P3:SPre+SG+P1:SPre+SG+P3:ImPre+SG+P2
nystagmus	nystagmus	Nom:Mas+InvPL
