constitu	oir	Ver:CPre+PL+P3
oaristys	oaristys	Nom:Fem+InvPL
oasienne	oasien	Adj:Fem+SG
oasienne	oasien	Nom:Fem+SG
oasiennes	oasien	Adj:Fem+PL
oasiennes	oasien	Nom:Fem+PL
oasien	oasien	Adj:Mas+SG
oasien	oasien	Nom:Mas+SG
oasis	oasis	Nom:Fem+InvPL
obédience	obédience	Nom:Fem+SG
obédiencier	obédiencier	Nom:Mas+SG
obédientielle	obédientiel	Adj:Fem+SG
obédientielles	obédientiel	Adj:Fem+PL
obédientiel	obédientiel	Adj:Mas+SG
obéie	obéir	Ver:PPas+Fem+SG
obéies	obéir	Ver:PPas+Fem+PL
obéîmes	obéir	Ver:IPSim+PL+P1
obéi	obéir	Ver:PPas+Mas+SG
obéiraient	obéir	Ver:CPre+PL+P3
obéirai	obéir	Ver:IFut+SG+P1
obéirais	obéir	Ver:CPre+SG+P1:CPre+SG+P2
obéirait	obéir	Ver:CPre+SG+P3
obéira	obéir	Ver:IFut+SG+P3
obéiras	obéir	Ver:IFut+SG+P2
obéirent	obéir	Ver:IPSim+PL+P3
obéirez	obéir	Ver:IFut+PL+P2
obéiriez	obéir	Ver:CPre+PL+P2
obéirions	obéir	Ver:CPre+PL+P1
obéir	obéir	Ver:Inf
obéirons	obéir	Ver:IFut+PL+P1
obéiront	obéir	Ver:IFut+PL+P3
obéis	obéir	Ver:IPre+SG+P1:IPre+SG+P2:IPSim+SG+P1:IPSim+SG+P2:ImPre+SG+P2
obéissaient	obéir	Ver:IImp+PL+P3
obéissais	obéir	Ver:IImp+SG+P1:IImp+SG+P2
obéissait	obéir	Ver:IImp+SG+P3
obéissance	obéissance	Nom:Fem+SG
obéissante	obéissant	Adj:Fem+SG
obéissantes	obéissant	Adj:Fem+PL
obéissant	obéir	Ver:PPre
obéissant	obéir	Ver:PPre
obéissant	obéir	Ver:PPre+Mas+SG
obéissant	obéissant	Adj:Mas+SG
obéissants	obéissant	Adj:Mas+PL
obéissent	obéir	Ver:IPre+PL+P3:SPre+PL+P3:SImp+PL+P3
obéisse	obéir	Ver:SPre+SG+P1:SPre+SG+P3:SImp+SG+P1
obéisses	obéir	Ver:SPre+SG+P2:SImp+SG+P2
obéissez	obéir	Ver:IPre+PL+P2:ImPre+PL+P2
obéissiez	obéir	Ver:IImp+PL+P2:SPre+PL+P2:SImp+PL+P2
obéissions	obéir	Ver:IImp+PL+P1:SPre+PL+P1:SImp+PL+P1
obéissons	obéir	Ver:IPre+PL+P1:ImPre+PL+P1
obéîtes	obéir	Ver:IPSim+PL+P2
obéit	obéir	Ver:IPre+SG+P3:IPSim+SG+P3
obéît	obéir	Ver:SImp+SG+P3
obèle	obèle	Nom:Mas+SG
obélisque	obélisque	Nom:Mas+SG
obélisques	obélisque	Nom:Mas+PL
obel	obel	Nom:Mas+SG
obéraient	obérer	Ver:IImp+PL+P3
obérai	obérer	Ver:IPSim+SG+P1
obérais	obérer	Ver:IImp+SG+P1:IImp+SG+P2
obérait	obérer	Ver:IImp+SG+P3
obérâmes	obérer	Ver:IPSim+PL+P1
obérant	obérer	Ver:PPre
obéra	obérer	Ver:IPSim+SG+P3
obéras	obérer	Ver:IPSim+SG+P2
obérassent	obérer	Ver:SImp+PL+P3
obérasse	obérer	Ver:SImp+SG+P1
obérasses	obérer	Ver:SImp+SG+P2
obérassiez	obérer	Ver:SImp+PL+P2
obérassions	obérer	Ver:SImp+PL+P1
obérâtes	obérer	Ver:IPSim+PL+P2
obérât	obérer	Ver:SImp+SG+P3
obérée	obéré	Adj:Fem+SG
obérée	obérée	Nom:Fem+SG
obérée	obérer	Ver:PPas+Fem+SG
obérées	obéré	Adj:Fem+PL
obérées	obérée	Nom:Fem+PL
obérées	obérer	Ver:PPas+Fem+PL
obèrent	obérer	Ver:IPre+PL+P3:SPre+PL+P3
obéré	obéré	Adj:Mas+SG
obère	obérer	Ver:IPre+SG+P1:IPre+SG+P3:SPre+SG+P1:SPre+SG+P3:ImPre+SG+P2
obéré	obérer	Ver:PPas+Mas+SG
obéreraient	obérer	Ver:CPre+PL+P3
obérerai	obérer	Ver:IFut+SG+P1
obérerais	obérer	Ver:CPre+SG+P1:CPre+SG+P2
obérerait	obérer	Ver:CPre+SG+P3
obérera	obérer	Ver:IFut+SG+P3
obéreras	obérer	Ver:IFut+SG+P2
obérèrent	obérer	Ver:IPSim+PL+P3
obérerez	obérer	Ver:IFut+PL+P2
obéreriez	obérer	Ver:CPre+PL+P2
obérerions	obérer	Ver:CPre+PL+P1
obérer	obérer	Ver:Inf
obérerons	obérer	Ver:IFut+PL+P1
obéreront	obérer	Ver:IFut+PL+P3
obérés	obéré	Adj:Mas+PL
obères	obérer	Ver:IPre+SG+P2:SPre+SG+P2
obérés	obérer	Ver:PPas+Mas+PL
obérez	obérer	Ver:IPre+PL+P2:ImPre+PL+P2
obériez	obérer	Ver:IImp+PL+P2:SPre+PL+P2
obérions	obérer	Ver:IImp+PL+P1:SPre+PL+P1
obérons	obérer	Ver:IPre+PL+P1:ImPre+PL+P1
obèse	obèse	Adj:InvGen+SG
obèse	obèse	Nom:InvGen+SG
obèses	obèse	Adj:InvGen+PL
obèses	obèse	Nom:InvGen+PL
obésité	obésité	Nom:Fem+SG
obier	obier	Nom:Mas+SG
obiers	obier	Nom:Mas+PL
obi	obi	Nom:Fem+SG
obis	obi	Nom:Fem+PL
obit	obit	Nom:Mas+SG
obituaire	obituaire	Adj:Mas+SG
obituaire	obituaire	Nom:Mas+SG
objectaient	objecter	Ver:IImp+PL+P3
objectai	objecter	Ver:IPSim+SG+P1
objectais	objecter	Ver:IImp+SG+P1:IImp+SG+P2
objectait	objecter	Ver:IImp+SG+P3
objectale	objectal	Adj:Fem+SG
objectales	objectal	Adj:Fem+PL
objectal	objectal	Adj:Mas+SG
objectâmes	objecter	Ver:IPSim+PL+P1
objectant	objecter	Ver:PPre
objecta	objecter	Ver:IPSim+SG+P3
objectas	objecter	Ver:IPSim+SG+P2
objectassent	objecter	Ver:SImp+PL+P3
objectasse	objecter	Ver:SImp+SG+P1
objectasses	objecter	Ver:SImp+SG+P2
objectassiez	objecter	Ver:SImp+PL+P2
objectassions	objecter	Ver:SImp+PL+P1
objectâtes	objecter	Ver:IPSim+PL+P2
objectât	objecter	Ver:SImp+SG+P3
objectaux	objectal	Adj:Mas+PL
objectée	objecter	Ver:PPas+Fem+SG
objectées	objecter	Ver:PPas+Fem+PL
objectent	objecter	Ver:IPre+PL+P3:SPre+PL+P3
objecte	objecter	Ver:IPre+SG+P1:IPre+SG+P3:SPre+SG+P1:SPre+SG+P3:ImPre+SG+P2
objecté	objecter	Ver:PPas+Mas+SG
objecteraient	objecter	Ver:CPre+PL+P3
objecterai	objecter	Ver:IFut+SG+P1
objecterais	objecter	Ver:CPre+SG+P1:CPre+SG+P2
objecterait	objecter	Ver:CPre+SG+P3
objectera	objecter	Ver:IFut+SG+P3
objecteras	objecter	Ver:IFut+SG+P2
objectèrent	objecter	Ver:IPSim+PL+P3
objecterez	objecter	Ver:IFut+PL+P2
objecteriez	objecter	Ver:CPre+PL+P2
objecterions	objecter	Ver:CPre+PL+P1
objecter	objecter	Ver:Inf
objecterons	objecter	Ver:IFut+PL+P1
objecteront	objecter	Ver:IFut+PL+P3
objectes	objecter	Ver:IPre+SG+P2:SPre+SG+P2
objectés	objecter	Ver:PPas+Mas+PL
objecteur	objecteur	Nom:Mas+SG
objecteurs	objecteur	Nom:Mas+PL
objectez	objecter	Ver:IPre+PL+P2:ImPre+PL+P2
objectiez	objecter	Ver:IImp+PL+P2:SPre+PL+P2
objectif	objectif	Adj:Mas+SG
objectif	objectif	Nom:Mas+SG
objectifs	objectif	Adj:Mas+PL
objectifs	objectif	Nom:Mas+PL
objection	objection	Nom:Fem+SG
objections	objecter	Ver:IImp+PL+P1:SPre+PL+P1
objections	objection	Nom:Fem+PL
objectivaient	objectiver	Ver:IImp+PL+P3
objectivai	objectiver	Ver:IPSim+SG+P1
objectivais	objectiver	Ver:IImp+SG+P1:IImp+SG+P2
objectivait	objectiver	Ver:IImp+SG+P3
objectivâmes	objectiver	Ver:IPSim+PL+P1
objectivant	objectiver	Ver:PPre
objectiva	objectiver	Ver:IPSim+SG+P3
objectivas	objectiver	Ver:IPSim+SG+P2
objectivassent	objectiver	Ver:SImp+PL+P3
objectivasse	objectiver	Ver:SImp+SG+P1
objectivasses	objectiver	Ver:SImp+SG+P2
objectivassiez	objectiver	Ver:SImp+PL+P2
objectivassions	objectiver	Ver:SImp+PL+P1
objectivâtes	objectiver	Ver:IPSim+PL+P2
objectivation	objectivation	Nom:Fem+SG
objectivations	objectivation	Nom:Fem+PL
objectivât	objectiver	Ver:SImp+SG+P3
objectivement	objectivement	Adv
objectivent	objectiver	Ver:IPre+PL+P3:SPre+PL+P3
objective	objectif	Adj:Fem+SG
objective	objectiver	Ver:IPre+SG+P1:IPre+SG+P3:SPre+SG+P1:SPre+SG+P3:ImPre+SG+P2
objectivé	objectiver	Ver:PPas+Mas+SG
objectiveraient	objectiver	Ver:CPre+PL+P3
objectiverai	objectiver	Ver:IFut+SG+P1
objectiverais	objectiver	Ver:CPre+SG+P1:CPre+SG+P2
objectiverait	objectiver	Ver:CPre+SG+P3
objectivera	objectiver	Ver:IFut+SG+P3
objectiveras	objectiver	Ver:IFut+SG+P2
objectivèrent	objectiver	Ver:IPSim+PL+P3
objectiverez	objectiver	Ver:IFut+PL+P2
objectiveriez	objectiver	Ver:CPre+PL+P2
objectiverions	objectiver	Ver:CPre+PL+P1
objectiver	objectiver	Ver:Inf
objectiverons	objectiver	Ver:IFut+PL+P1
objectiveront	objectiver	Ver:IFut+PL+P3
objectives	objectif	Adj:Fem+PL
objectives	objectiver	Ver:IPre+SG+P2:SPre+SG+P2
objectivez	objectiver	Ver:IPre+PL+P2:ImPre+PL+P2
objectiviez	objectiver	Ver:IImp+PL+P2:SPre+PL+P2
objectivions	objectiver	Ver:IImp+PL+P1:SPre+PL+P1
objectivisme	objectivisme	Nom:Mas+SG
objectiviste	objectiviste	Adj:InvGen+SG
objectiviste	objectiviste	Nom:InvGen+SG
objectivité	objectivité	Nom:Fem+SG
objectivons	objectiver	Ver:IPre+PL+P1:ImPre+PL+P1
objectons	objecter	Ver:IPre+PL+P1:ImPre+PL+P1
objet	objet	Nom:Mas+SG
objets	objet	Nom:Mas+PL
objurgation	objurgation	Nom:Fem+SG
objurgations	objurgation	Nom:Fem+PL
oblate	oblat	Nom:Fem+SG
oblates	oblat	Nom:Fem+PL
oblatif	oblatif	Adj:Mas+SG
oblation	oblation	Nom:Fem+SG
oblat	oblat	Nom:Mas+SG
oblature	oblature	Nom:Fem+SG
obligataire	obligataire	Adj:InvGen+SG
obligataires	obligataire	Adj:InvGen+PL
obligataires	obligataire	Nom:InvGen+PL
obligation	obligation	Nom:Fem+SG
obligations	obligation	Nom:Fem+PL
obligations	obligations	Nom:Fem+PL
obligatoirement	obligatoirement	Adv
obligatoire	obligatoire	Adj:InvGen+SG
obligatoires	obligatoire	Adj:InvGen+PL
obligeaient	obliger	Ver:IImp+PL+P3
obligeai	obliger	Ver:IPSim+SG+P1
obligeais	obliger	Ver:IImp+SG+P1
obligeais	obliger	Ver:IImp+SG+P2
obligeait	obliger	Ver:IImp+SG+P3
obligeâmes	obliger	Ver:IPSim+PL+P1
obligeamment	obligeamment	Adv
obligeance	obligeance	Nom:Fem+SG
obligeante	obligeant	Adj:Fem+SG
obligeante	obliger	Ver:PPre+Fem+SG
obligeantes	obligeant	Adj:Fem+PL
obligeantes	obliger	Ver:PPre+Fem+PL
obligeant	obligeant	Adj:Mas+SG
obligeant	obliger	Ver:PPre
obligeants	obligeant	Adj:Mas+PL
obligea	obliger	Ver:IPSim+SG+P3
obligeas	obliger	Ver:IPSim+SG+P2
obligeassent	obliger	Ver:SImp+PL+P3
obligeasse	obliger	Ver:SImp+SG+P1
obligeasses	obliger	Ver:SImp+SG+P2
obligeassiez	obliger	Ver:SImp+PL+P2
obligeassions	obliger	Ver:SImp+PL+P1
obligeâtes	obliger	Ver:IPSim+PL+P2
obligeât	obliger	Ver:SImp+SG+P3
obligée	obligé	Adj:Fem+SG
obligée	obligé	Nom:Fem+SG
obligée	obliger	Ver:PPas+Fem+SG
obligées	obligé	Adj:Fem+PL
obligées	obligé	Nom:Fem+PL
obligées	obliger	Ver:PPas+Fem+PL
obligent	obliger	Ver:IPre+PL+P3:SPre+PL+P3
obligé	obligé	Adj:Mas+SG
obligé	obligé	Nom:Mas+SG
oblige	obliger	Ver:IPre+SG+P1:IPre+SG+P3:SPre+SG+P1:SPre+SG+P3:ImPre+SG+P2
obligé	obliger	Ver:PPas+Mas+SG
obligeons	obliger	Ver:Imp+PL+P1
obligeons	obliger	Ver:IPre+PL+P1
obligeraient	obliger	Ver:CPre+PL+P3
obligerai	obliger	Ver:IFut+SG+P1
obligerais	obliger	Ver:CPre+SG+P1:CPre+SG+P2
obligerait	obliger	Ver:CPre+SG+P3
obligera	obliger	Ver:IFut+SG+P3
obligeras	obliger	Ver:IFut+SG+P2
obligèrent	obliger	Ver:IPSim+PL+P3
obligerez	obliger	Ver:IFut+PL+P2
obligeriez	obliger	Ver:CPre+PL+P2
obligerions	obliger	Ver:CPre+PL+P1
obliger	obliger	Ver:Inf
obligerons	obliger	Ver:IFut+PL+P1
obligeront	obliger	Ver:IFut+PL+P3
obligés	obligé	Adj:Mas+PL
obligés	obligé	Nom:Mas+PL
obliges	obliger	Ver:IPre+SG+P2:SPre+SG+P2
obligés	obliger	Ver:PPas+Mas+PL
obligez	obliger	Ver:Imp+PL+P2
obligez	obliger	Ver:IPre+PL+P2
obligiez	obliger	Ver:IImp+PL+P2:SPre+PL+P2
obligions	obliger	Ver:IImp+PL+P1:SPre+PL+P1
obliquaient	obliquer	Ver:IImp+PL+P3
obliquai	obliquer	Ver:IPSim+SG+P1
obliquais	obliquer	Ver:IImp+SG+P1:IImp+SG+P2
obliquait	obliquer	Ver:IImp+SG+P3
obliquâmes	obliquer	Ver:IPSim+PL+P1
obliquant	obliquer	Ver:PPre
obliqua	obliquer	Ver:IPSim+SG+P3
obliquas	obliquer	Ver:IPSim+SG+P2
obliquassent	obliquer	Ver:SImp+PL+P3
obliquasse	obliquer	Ver:SImp+SG+P1
obliquasses	obliquer	Ver:SImp+SG+P2
obliquassiez	obliquer	Ver:SImp+PL+P2
obliquassions	obliquer	Ver:SImp+PL+P1
obliquâtes	obliquer	Ver:IPSim+PL+P2
obliquât	obliquer	Ver:SImp+SG+P3
obliquée	obliquer	Ver:PPas+Fem+SG
obliquées	obliquer	Ver:PPas+Fem+PL
obliquement	obliquement	Adv
obliquent	obliquer	Ver:IPre+PL+P3:SPre+PL+P3
oblique	oblique	Adj:InvGen+SG
oblique	oblique	Nom:Fem+SG
oblique	oblique	Nom:Mas+SG
oblique	obliquer	Ver:IPre+SG+P1:IPre+SG+P3:SPre+SG+P1:SPre+SG+P3:ImPre+SG+P2
obliqué	obliquer	Ver:PPas+Mas+SG
obliqueraient	obliquer	Ver:CPre+PL+P3
obliquerai	obliquer	Ver:IFut+SG+P1
obliquerais	obliquer	Ver:CPre+SG+P1:CPre+SG+P2
obliquerait	obliquer	Ver:CPre+SG+P3
obliquera	obliquer	Ver:IFut+SG+P3
obliqueras	obliquer	Ver:IFut+SG+P2
obliquèrent	obliquer	Ver:IPSim+PL+P3
obliquerez	obliquer	Ver:IFut+PL+P2
obliqueriez	obliquer	Ver:CPre+PL+P2
obliquerions	obliquer	Ver:CPre+PL+P1
obliquer	obliquer	Ver:Inf
obliquerons	obliquer	Ver:IFut+PL+P1
obliqueront	obliquer	Ver:IFut+PL+P3
obliques	oblique	Adj:InvGen+PL
obliques	oblique	Nom:Fem+PL
obliques	oblique	Nom:Mas+PL
obliques	obliquer	Ver:IPre+SG+P2:SPre+SG+P2
obliqués	obliquer	Ver:PPas+Mas+PL
obliquez	obliquer	Ver:IPre+PL+P2:ImPre+PL+P2
obliquiez	obliquer	Ver:IImp+PL+P2:SPre+PL+P2
obliquions	obliquer	Ver:IImp+PL+P1:SPre+PL+P1
obliquité	obliquité	Nom:Fem+SG
obliquons	obliquer	Ver:IPre+PL+P1:ImPre+PL+P1
oblitéraient	oblitérer	Ver:IImp+PL+P3
oblitérai	oblitérer	Ver:IPSim+SG+P1
oblitérais	oblitérer	Ver:IImp+SG+P1:IImp+SG+P2
oblitérait	oblitérer	Ver:IImp+SG+P3
oblitérâmes	oblitérer	Ver:IPSim+PL+P1
oblitérant	oblitérant	Adj:Mas+SG
oblitérant	oblitérer	Ver:PPre
oblitéra	oblitérer	Ver:IPSim+SG+P3
oblitéras	oblitérer	Ver:IPSim+SG+P2
oblitérassent	oblitérer	Ver:SImp+PL+P3
oblitérasse	oblitérer	Ver:SImp+SG+P1
oblitérasses	oblitérer	Ver:SImp+SG+P2
oblitérassiez	oblitérer	Ver:SImp+PL+P2
oblitérassions	oblitérer	Ver:SImp+PL+P1
oblitérâtes	oblitérer	Ver:IPSim+PL+P2
oblitérateur	oblitérateur	Adj:Mas+SG
oblitérateur	oblitérateur	Nom:Mas+SG
oblitération	oblitération	Nom:Fem+SG
oblitérations	oblitération	Nom:Fem+PL
oblitérât	oblitérer	Ver:SImp+SG+P3
oblitératrice	oblitérateur	Adj:Fem+SG
oblitérée	oblitérer	Ver:PPas+Fem+SG
oblitérées	oblitérer	Ver:PPas+Fem+PL
oblitèrent	oblitérer	Ver:IPre+PL+P3:SPre+PL+P3
oblitère	oblitérer	Ver:IPre+SG+P1:IPre+SG+P3:SPre+SG+P1:SPre+SG+P3:ImPre+SG+P2
oblitéré	oblitérer	Ver:PPas+Mas+SG
oblitéreraient	oblitérer	Ver:CPre+PL+P3
oblitérerai	oblitérer	Ver:IFut+SG+P1
oblitérerais	oblitérer	Ver:CPre+SG+P1:CPre+SG+P2
oblitérerait	oblitérer	Ver:CPre+SG+P3
oblitérera	oblitérer	Ver:IFut+SG+P3
oblitéreras	oblitérer	Ver:IFut+SG+P2
oblitérèrent	oblitérer	Ver:IPSim+PL+P3
oblitérerez	oblitérer	Ver:IFut+PL+P2
oblitéreriez	oblitérer	Ver:CPre+PL+P2
oblitérerions	oblitérer	Ver:CPre+PL+P1
oblitérer	oblitérer	Ver:Inf
oblitérerons	oblitérer	Ver:IFut+PL+P1
oblitéreront	oblitérer	Ver:IFut+PL+P3
oblitères	oblitérer	Ver:IPre+SG+P2:SPre+SG+P2
oblitérés	oblitérer	Ver:PPas+Mas+PL
oblitérez	oblitérer	Ver:IPre+PL+P2:ImPre+PL+P2
oblitériez	oblitérer	Ver:IImp+PL+P2:SPre+PL+P2
oblitérions	oblitérer	Ver:IImp+PL+P1:SPre+PL+P1
oblitérons	oblitérer	Ver:IPre+PL+P1:ImPre+PL+P1
oblong	oblong	Adj:Mas+SG
oblongs	oblong	Adj:Mas+PL
oblongue	oblong	Adj:Fem+SG
oblongues	oblong	Adj:Fem+PL
obnubilaient	obnubiler	Ver:IImp+PL+P3
obnubilai	obnubiler	Ver:IPSim+SG+P1
obnubilais	obnubiler	Ver:IImp+SG+P1:IImp+SG+P2
obnubilait	obnubiler	Ver:IImp+SG+P3
obnubilâmes	obnubiler	Ver:IPSim+PL+P1
obnubilant	obnubiler	Ver:PPre
obnubila	obnubiler	Ver:IPSim+SG+P3
obnubilas	obnubiler	Ver:IPSim+SG+P2
obnubilassent	obnubiler	Ver:SImp+PL+P3
obnubilasse	obnubiler	Ver:SImp+SG+P1
obnubilasses	obnubiler	Ver:SImp+SG+P2
obnubilassiez	obnubiler	Ver:SImp+PL+P2
obnubilassions	obnubiler	Ver:SImp+PL+P1
obnubilâtes	obnubiler	Ver:IPSim+PL+P2
obnubilation	obnubilation	Nom:Fem+SG
obnubilations	obnubilation	Nom:Fem+PL
obnubilât	obnubiler	Ver:SImp+SG+P3
obnubilée	obnubiler	Ver:PPas+Fem+SG
obnubilées	obnubiler	Ver:PPas+Fem+PL
obnubilent	obnubiler	Ver:IPre+PL+P3:SPre+PL+P3
obnubile	obnubiler	Ver:IPre+SG+P1:IPre+SG+P3:SPre+SG+P1:SPre+SG+P3:ImPre+SG+P2
obnubilé	obnubiler	Ver:PPas+Mas+SG
obnubileraient	obnubiler	Ver:CPre+PL+P3
obnubilerai	obnubiler	Ver:IFut+SG+P1
obnubilerais	obnubiler	Ver:CPre+SG+P1:CPre+SG+P2
obnubilerait	obnubiler	Ver:CPre+SG+P3
obnubilera	obnubiler	Ver:IFut+SG+P3
obnubileras	obnubiler	Ver:IFut+SG+P2
obnubilèrent	obnubiler	Ver:IPSim+PL+P3
obnubilerez	obnubiler	Ver:IFut+PL+P2
obnubileriez	obnubiler	Ver:CPre+PL+P2
obnubilerions	obnubiler	Ver:CPre+PL+P1
obnubiler	obnubiler	Ver:Inf
obnubilerons	obnubiler	Ver:IFut+PL+P1
obnubileront	obnubiler	Ver:IFut+PL+P3
obnubiles	obnubiler	Ver:IPre+SG+P2:SPre+SG+P2
obnubilés	obnubiler	Ver:PPas+Mas+PL
obnubilez	obnubiler	Ver:IPre+PL+P2:ImPre+PL+P2
obnubiliez	obnubiler	Ver:IImp+PL+P2:SPre+PL+P2
obnubilions	obnubiler	Ver:IImp+PL+P1:SPre+PL+P1
obnubilons	obnubiler	Ver:IPre+PL+P1:ImPre+PL+P1
obole	obole	Nom:Fem+SG
oboles	obole	Nom:Fem+PL
obombraient	obombrer	Ver:IImp+PL+P3
obombrai	obombrer	Ver:IPSim+SG+P1
obombrais	obombrer	Ver:IImp+SG+P1:IImp+SG+P2
obombrait	obombrer	Ver:IImp+SG+P3
obombrâmes	obombrer	Ver:IPSim+PL+P1
obombrant	obombrer	Ver:PPre
obombra	obombrer	Ver:IPSim+SG+P3
obombras	obombrer	Ver:IPSim+SG+P2
obombrassent	obombrer	Ver:SImp+PL+P3
obombrasse	obombrer	Ver:SImp+SG+P1
obombrasses	obombrer	Ver:SImp+SG+P2
obombrassiez	obombrer	Ver:SImp+PL+P2
obombrassions	obombrer	Ver:SImp+PL+P1
obombrâtes	obombrer	Ver:IPSim+PL+P2
obombrât	obombrer	Ver:SImp+SG+P3
obombrent	obombrer	Ver:IPre+PL+P3:SPre+PL+P3
obombre	obombrer	Ver:IPre+SG+P1:IPre+SG+P3:SPre+SG+P1:SPre+SG+P3:ImPre+SG+P2
obombré	obombrer	Ver:PPas+Mas+SG
obombrèrent	obombrer	Ver:IPSim+PL+P3
obombrer	obombrer	Ver:Inf
obombres	obombrer	Ver:IPre+SG+P2:SPre+SG+P2
obombrez	obombrer	Ver:IPre+PL+P2:ImPre+PL+P2
obombriez	obombrer	Ver:IImp+PL+P2:SPre+PL+P2
obombrions	obombrer	Ver:IImp+PL+P1:SPre+PL+P1
obombrons	obombrer	Ver:IPre+PL+P1:ImPre+PL+P1
obscène	obscène	Adj:InvGen+SG
obscènes	obscène	Adj:InvGen+PL
obscénité	obscénité	Nom:Fem+SG
obscénités	obscénité	Nom:Fem+PL
obscurantisme	obscurantisme	Nom:Mas+SG
obscurantiste	obscurantiste	Adj:InvGen+SG
obscurantiste	obscurantiste	Nom:InvGen+SG
obscurantistes	obscurantiste	Adj:InvGen+PL
obscurantistes	obscurantiste	Nom:InvGen+PL
obscurcie	obscurcir	Ver:PPas+Fem+SG
obscurcies	obscurcir	Ver:PPas+Fem+PL
obscurcîmes	obscurcir	Ver:IPSim+PL+P1
obscurci	obscurcir	Ver:PPas+Mas+SG
obscurciraient	obscurcir	Ver:CPre+PL+P3
obscurcirai	obscurcir	Ver:IFut+SG+P1
obscurcirais	obscurcir	Ver:CPre+SG+P1:CPre+SG+P2
obscurcirait	obscurcir	Ver:CPre+SG+P3
obscurcira	obscurcir	Ver:IFut+SG+P3
obscurciras	obscurcir	Ver:IFut+SG+P2
obscurcirent	obscurcir	Ver:IPSim+PL+P3
obscurcirez	obscurcir	Ver:IFut+PL+P2
obscurciriez	obscurcir	Ver:CPre+PL+P2
obscurcirions	obscurcir	Ver:CPre+PL+P1
obscurcir	obscurcir	Ver:Inf
obscurcirons	obscurcir	Ver:IFut+PL+P1
obscurciront	obscurcir	Ver:IFut+PL+P3
obscurcis	obscurcir	Ver:PPas+Mas+PL:IPre+SG+P1:IPre+SG+P2:IPSim+SG+P1:IPSim+SG+P2:ImPre+SG+P2
obscurcissaient	obscurcir	Ver:IImp+PL+P3
obscurcissais	obscurcir	Ver:IImp+SG+P1:IImp+SG+P2
obscurcissait	obscurcir	Ver:IImp+SG+P3
obscurcissant	obscurcir	Ver:PPre
obscurcissant	obscurcir	Ver:PPre
obscurcissant	obscurcir	Ver:PPre+Mas+SG
obscurcissement	obscurcissement	Nom:Mas+SG
obscurcissent	obscurcir	Ver:IPre+PL+P3:SPre+PL+P3:SImp+PL+P3
obscurcisse	obscurcir	Ver:SPre+SG+P1:SPre+SG+P3:SImp+SG+P1
obscurcisses	obscurcir	Ver:SPre+SG+P2:SImp+SG+P2
obscurcissez	obscurcir	Ver:IPre+PL+P2:ImPre+PL+P2
obscurcissiez	obscurcir	Ver:IImp+PL+P2:SPre+PL+P2:SImp+PL+P2
obscurcissions	obscurcir	Ver:IImp+PL+P1:SPre+PL+P1:SImp+PL+P1
obscurcissons	obscurcir	Ver:IPre+PL+P1:ImPre+PL+P1
obscurcîtes	obscurcir	Ver:IPSim+PL+P2
obscurcit	obscurcir	Ver:IPre+SG+P3:IPSim+SG+P3
obscurcît	obscurcir	Ver:SImp+SG+P3
obscurément	obscurément	Adv
obscure	obscur	Adj:Fem+SG
obscures	obscur	Adj:Fem+PL
obscurité	obscurité	Nom:Fem+SG
obscurités	obscurité	Nom:Fem+PL
obscur	obscur	Adj:Mas+SG
obscurs	obscur	Adj:Mas+PL
obsécration	obsécration	Nom:Fem+SG
obsédaient	obséder	Ver:IImp+PL+P3
obsédai	obséder	Ver:IPSim+SG+P1
obsédais	obséder	Ver:IImp+SG+P1:IImp+SG+P2
obsédait	obséder	Ver:IImp+SG+P3
obsédâmes	obséder	Ver:IPSim+PL+P1
obsédante	obsédant	Adj:Fem+SG
obsédantes	obsédant	Adj:Fem+PL
obsédant	obsédant	Adj:Mas+SG
obsédant	obséder	Ver:PPre
obsédants	obsédant	Adj:Mas+PL
obséda	obséder	Ver:IPSim+SG+P3
obsédas	obséder	Ver:IPSim+SG+P2
obsédassent	obséder	Ver:SImp+PL+P3
obsédasse	obséder	Ver:SImp+SG+P1
obsédasses	obséder	Ver:SImp+SG+P2
obsédassiez	obséder	Ver:SImp+PL+P2
obsédassions	obséder	Ver:SImp+PL+P1
obsédâtes	obséder	Ver:IPSim+PL+P2
obsédât	obséder	Ver:SImp+SG+P3
obsédée	obsédé	Adj:Fem+SG
obsédée	obsédé	Nom:Fem+SG
obsédée	obséder	Ver:PPas+Fem+SG
obsédées	obsédé	Adj:Fem+PL
obsédées	obsédé	Nom:Fem+PL
obsédées	obséder	Ver:PPas+Fem+PL
obsèdent	obséder	Ver:IPre+PL+P3:SPre+PL+P3
obsédé	obsédé	Adj:Mas+SG
obsédé	obsédé	Nom:Mas+SG
obsède	obséder	Ver:IPre+SG+P1:IPre+SG+P3:SPre+SG+P1:SPre+SG+P3:ImPre+SG+P2
obsédé	obséder	Ver:PPas+Mas+SG
obséderaient	obséder	Ver:CPre+PL+P3
obséderai	obséder	Ver:IFut+SG+P1
obséderais	obséder	Ver:CPre+SG+P1:CPre+SG+P2
obséderait	obséder	Ver:CPre+SG+P3
obsédera	obséder	Ver:IFut+SG+P3
obséderas	obséder	Ver:IFut+SG+P2
obsédèrent	obséder	Ver:IPSim+PL+P3
obséderez	obséder	Ver:IFut+PL+P2
obséderiez	obséder	Ver:CPre+PL+P2
obséderions	obséder	Ver:CPre+PL+P1
obséder	obséder	Ver:Inf
obséderons	obséder	Ver:IFut+PL+P1
obséderont	obséder	Ver:IFut+PL+P3
obsédés	obsédé	Adj:Mas+PL
obsédés	obsédé	Nom:Mas+PL
obsèdes	obséder	Ver:IPre+SG+P2:SPre+SG+P2
obsédés	obséder	Ver:PPas+Mas+PL
obsédez	obséder	Ver:IPre+PL+P2:ImPre+PL+P2
obsédiez	obséder	Ver:IImp+PL+P2:SPre+PL+P2
obsédions	obséder	Ver:IImp+PL+P1:SPre+PL+P1
obsédons	obséder	Ver:IPre+PL+P1:ImPre+PL+P1
obsèques	obsèques	Nom:Fem+PL
obséquieusement	obséquieusement	Adv
obséquieuse	obséquieux	Adj:Fem+SG
obséquieuses	obséquieux	Adj:Fem+PL
obséquieux	obséquieux	Adj:Mas+InvPL
obséquiosité	obséquiosité	Nom:Fem+SG
obséquiosités	obséquiosité	Nom:Fem+PL
observable	observable	Adj:InvGen+SG
observables	observable	Adj:InvGen+PL
observaient	observer	Ver:IImp+PL+P3
observai	observer	Ver:IPSim+SG+P1
observais	observer	Ver:IImp+SG+P1:IImp+SG+P2
observait	observer	Ver:IImp+SG+P3
observâmes	observer	Ver:IPSim+PL+P1
observance	observance	Nom:Fem+SG
observant	observant	Adj:Mas+SG
observant	observant	Nom:Mas+SG
observant	observer	Ver:PPre
observa	observer	Ver:IPSim+SG+P3
observas	observer	Ver:IPSim+SG+P2
observassent	observer	Ver:SImp+PL+P3
observasse	observer	Ver:SImp+SG+P1
observasses	observer	Ver:SImp+SG+P2
observassiez	observer	Ver:SImp+PL+P2
observassions	observer	Ver:SImp+PL+P1
observâtes	observer	Ver:IPSim+PL+P2
observateur	observateur	Adj:Mas+SG
observateur	observateur	Nom:Mas+SG
observateurs	observateur	Adj:Mas+PL
observateurs	observateur	Nom:Mas+PL
observation	observation	Nom:Fem+SG
observations	observation	Nom:Fem+PL
observât	observer	Ver:SImp+SG+P3
observatoire	observatoire	Nom:Mas+SG
observatoires	observatoire	Nom:Mas+PL
observatrice	observateur	Adj:Fem+SG
observatrice	observateur	Nom:Fem+SG
observatrices	observateur	Adj:Fem+PL
observatrices	observateur	Nom:Fem+PL
observée	observer	Ver:PPas+Fem+SG
observées	observer	Ver:PPas+Fem+PL
observent	observer	Ver:IPre+PL+P3:SPre+PL+P3
observe	observer	Ver:IPre+SG+P1:IPre+SG+P3:SPre+SG+P1:SPre+SG+P3:ImPre+SG+P2
observé	observer	Ver:PPas+Mas+SG
observeraient	observer	Ver:CPre+PL+P3
observerai	observer	Ver:IFut+SG+P1
observerais	observer	Ver:CPre+SG+P1:CPre+SG+P2
observerait	observer	Ver:CPre+SG+P3
observera	observer	Ver:IFut+SG+P3
observeras	observer	Ver:IFut+SG+P2
observèrent	observer	Ver:IPSim+PL+P3
observerez	observer	Ver:IFut+PL+P2
observeriez	observer	Ver:CPre+PL+P2
observerions	observer	Ver:CPre+PL+P1
observer	observer	Ver:Inf
observerons	observer	Ver:IFut+PL+P1
observeront	observer	Ver:IFut+PL+P3
observes	observer	Ver:IPre+SG+P2:SPre+SG+P2
observés	observer	Ver:PPas+Mas+PL
observez	observer	Ver:IPre+PL+P2:ImPre+PL+P2
observiez	observer	Ver:IImp+PL+P2:SPre+PL+P2
observions	observer	Ver:IImp+PL+P1:SPre+PL+P1
observons	observer	Ver:IPre+PL+P1:ImPre+PL+P1
obsessionnelle	obsessionnel	Adj:Fem+SG
obsessionnelles	obsessionnel	Adj:Fem+PL
obsessionnel	obsessionnel	Adj:Mas+SG
obsessionnels	obsessionnel	Adj:Mas+PL
obsession	obsession	Nom:Fem+SG
obsessions	obsession	Nom:Fem+PL
obsidienne	obsidienne	Nom:Fem+SG
obsidionale	obsidional	Adj:Fem+SG
obsidionales	obsidional	Adj:Fem+PL
obsidional	obsidional	Adj:Mas+SG
obsidionaux	obsidional	Adj:Mas+PL
obsolescence	obsolescence	Nom:Fem+SG
obsolescences	obsolescence	Nom:Fem+PL
obsolescente	obsolescent	Adj:Fem+SG
obsolescentes	obsolescent	Adj:Fem+PL
obsolescent	obsolescent	Adj:Mas+SG
obsolescents	obsolescent	Adj:Mas+PL
obsolète	obsolète	Adj:InvGen+SG
obsolètes	obsolète	Adj:InvGen+PL
obstacle	obstacle	Nom:Mas+SG
obstacles	obstacle	Nom:Mas+PL
obstétricale	obstétrical	Adj:Fem+SG
obstétricales	obstétrical	Adj:Fem+PL
obstétrical	obstétrical	Adj:Mas+SG
obstétricaux	obstétrical	Adj:Mas+PL
obstétricienne	obstétricien	Nom:Fem+SG
obstétriciennes	obstétricien	Nom:Fem+PL
obstétricien	obstétricien	Nom:Mas+SG
obstétriciens	obstétricien	Nom:Mas+PL
obstétrique	obstétrique	Adj:InvGen+SG
obstétrique	obstétrique	Nom:Fem+SG
obstétriques	obstétrique	Adj:InvGen+PL
obstétriques	obstétrique	Nom:Fem+PL
obstinaient	obstiner	Ver:IImp+PL+P3
obstinai	obstiner	Ver:IPSim+SG+P1
obstinais	obstiner	Ver:IImp+SG+P1:IImp+SG+P2
obstinait	obstiner	Ver:IImp+SG+P3
obstinâmes	obstiner	Ver:IPSim+PL+P1
obstinant	obstiner	Ver:PPre
obstina	obstiner	Ver:IPSim+SG+P3
obstinas	obstiner	Ver:IPSim+SG+P2
obstinassent	obstiner	Ver:SImp+PL+P3
obstinasse	obstiner	Ver:SImp+SG+P1
obstinasses	obstiner	Ver:SImp+SG+P2
obstinassiez	obstiner	Ver:SImp+PL+P2
obstinassions	obstiner	Ver:SImp+PL+P1
obstinâtes	obstiner	Ver:IPSim+PL+P2
obstination	obstination	Nom:Fem+SG
obstinations	obstination	Nom:Fem+PL
obstinât	obstiner	Ver:SImp+SG+P3
obstinée	obstiné	Adj:Fem+SG
obstinée	obstiné	Nom:Fem+SG
obstinée	obstiner	Ver:PPas+Fem+SG
obstinées	obstiné	Adj:Fem+PL
obstinées	obstiné	Nom:Fem+PL
obstinées	obstiner	Ver:PPas+Fem+PL
obstinément	obstinément	Adv
obstinent	obstiner	Ver:IPre+PL+P3:SPre+PL+P3
obstiné	obstiné	Adj:Mas+SG
obstiné	obstiné	Nom:Mas+SG
obstine	obstiner	Ver:IPre+SG+P1:IPre+SG+P3:SPre+SG+P1:SPre+SG+P3:ImPre+SG+P2
obstiné	obstiner	Ver:PPas+Mas+SG
obstineraient	obstiner	Ver:CPre+PL+P3
obstinerai	obstiner	Ver:IFut+SG+P1
obstinerais	obstiner	Ver:CPre+SG+P1:CPre+SG+P2
obstinerait	obstiner	Ver:CPre+SG+P3
obstinera	obstiner	Ver:IFut+SG+P3
obstineras	obstiner	Ver:IFut+SG+P2
obstinèrent	obstiner	Ver:IPSim+PL+P3
obstinerez	obstiner	Ver:IFut+PL+P2
obstineriez	obstiner	Ver:CPre+PL+P2
obstinerions	obstiner	Ver:CPre+PL+P1
obstiner	obstiner	Ver:Inf
obstinerons	obstiner	Ver:IFut+PL+P1
obstineront	obstiner	Ver:IFut+PL+P3
obstinés	obstiné	Adj:Mas+PL
obstinés	obstiné	Nom:Mas+PL
obstines	obstiner	Ver:IPre+SG+P2:SPre+SG+P2
obstinés	obstiner	Ver:PPas+Mas+PL
obstinez	obstiner	Ver:IPre+PL+P2:ImPre+PL+P2
obstiniez	obstiner	Ver:IImp+PL+P2
obstiniez	obstiner	Ver:SPre+PL+P2
obstinions	obstiner	Ver:IImp+PL+P1
obstinions	obstiner	Ver:SPre+PL+P1
obstinons	obstiner	Ver:IPre+PL+P1:ImPre+PL+P1
obstruaient	obstruer	Ver:IImp+PL+P3
obstruai	obstruer	Ver:IPSim+SG+P1
obstruais	obstruer	Ver:IImp+SG+P1:IImp+SG+P2
obstruait	obstruer	Ver:IImp+SG+P3
obstruâmes	obstruer	Ver:IPSim+PL+P1
obstruant	obstruer	Ver:PPre
obstrua	obstruer	Ver:IPSim+SG+P3
obstruas	obstruer	Ver:IPSim+SG+P2
obstruassent	obstruer	Ver:SImp+PL+P3
obstruasse	obstruer	Ver:SImp+SG+P1
obstruasses	obstruer	Ver:SImp+SG+P2
obstruassiez	obstruer	Ver:SImp+PL+P2
obstruassions	obstruer	Ver:SImp+PL+P1
obstruâtes	obstruer	Ver:IPSim+PL+P2
obstruât	obstruer	Ver:SImp+SG+P3
obstructif	obstructif	Adj:Mas+SG
obstructionnisme	obstructionnisme	Nom:Mas+SG
obstructionniste	obstructionniste	Adj:InvGen+SG
obstructionniste	obstructionniste	Nom:InvGen+SG
obstructionnistes	obstructionniste	Adj:InvGen+PL
obstructionnistes	obstructionniste	Nom:InvGen+PL
obstruction	obstruction	Nom:Fem+SG
obstructions	obstruction	Nom:Fem+PL
obstructive	obstructif	Adj:Fem+SG
obstructives	obstructif	Adj:Fem+PL
obstruée	obstrué	Adj:Fem+SG
obstruée	obstruer	Ver:PPas+Fem+SG
obstruées	obstrué	Adj:Fem+PL
obstruées	obstruer	Ver:PPas+Fem+PL
obstruent	obstruer	Ver:IPre+PL+P3:SPre+PL+P3
obstrué	obstrué	Adj:Mas+SG
obstrue	obstruer	Ver:IPre+SG+P1:IPre+SG+P3:SPre+SG+P1:SPre+SG+P3:ImPre+SG+P2
obstrué	obstruer	Ver:PPas+Mas+SG
obstrueraient	obstruer	Ver:CPre+PL+P3
obstruerai	obstruer	Ver:IFut+SG+P1
obstruerais	obstruer	Ver:CPre+SG+P1:CPre+SG+P2
obstruerait	obstruer	Ver:CPre+SG+P3
obstruera	obstruer	Ver:IFut+SG+P3
obstrueras	obstruer	Ver:IFut+SG+P2
obstruèrent	obstruer	Ver:IPSim+PL+P3
obstruerez	obstruer	Ver:IFut+PL+P2
obstrueriez	obstruer	Ver:CPre+PL+P2
obstruerions	obstruer	Ver:CPre+PL+P1
obstruer	obstruer	Ver:Inf
obstruerons	obstruer	Ver:IFut+PL+P1
obstrueront	obstruer	Ver:IFut+PL+P3
obstrués	obstrué	Adj:Mas+PL
obstrues	obstruer	Ver:IPre+SG+P2:SPre+SG+P2
obstrués	obstruer	Ver:PPas+Mas+PL
obstruez	obstruer	Ver:IPre+PL+P2:ImPre+PL+P2
obstruiez	obstruer	Ver:IImp+PL+P2:SPre+PL+P2
obstruions	obstruer	Ver:IImp+PL+P1:SPre+PL+P1
obstruons	obstruer	Ver:IPre+PL+P1:ImPre+PL+P1
obtempéraient	obtempérer	Ver:IImp+PL+P3
obtempérai	obtempérer	Ver:IPSim+SG+P1
obtempérais	obtempérer	Ver:IImp+SG+P1:IImp+SG+P2
obtempérait	obtempérer	Ver:IImp+SG+P3
obtempérâmes	obtempérer	Ver:IPSim+PL+P1
obtempérant	obtempérer	Ver:PPre
obtempéra	obtempérer	Ver:IPSim+SG+P3
obtempéras	obtempérer	Ver:IPSim+SG+P2
obtempérassent	obtempérer	Ver:SImp+PL+P3
obtempérasse	obtempérer	Ver:SImp+SG+P1
obtempérasses	obtempérer	Ver:SImp+SG+P2
obtempérassiez	obtempérer	Ver:SImp+PL+P2
obtempérassions	obtempérer	Ver:SImp+PL+P1
obtempérâtes	obtempérer	Ver:IPSim+PL+P2
obtempérât	obtempérer	Ver:SImp+SG+P3
obtempèrent	obtempérer	Ver:IPre+PL+P3
obtempèrent	obtempérer	Ver:SPre+PL+P3
obtempère	obtempérer	Ver:Imp+SG+P2
obtempère	obtempérer	Ver:IPre+SG+P1
obtempère	obtempérer	Ver:IPre+SG+P3
obtempéré	obtempérer	Ver:PPas+Mas+SG
obtempère	obtempérer	Ver:SPre+SG+P1
obtempère	obtempérer	Ver:SPre+SG+P3
obtempéreraient	obtempérer	Ver:CPre+PL+P3
obtempérerai	obtempérer	Ver:IFut+SG+P1
obtempérerais	obtempérer	Ver:CPre+SG+P1
obtempérerais	obtempérer	Ver:CPre+SG+P2
obtempérerait	obtempérer	Ver:CPre+SG+P3
obtempérera	obtempérer	Ver:IFut+SG+P3
obtempéreras	obtempérer	Ver:IFut+SG+P2
obtempérèrent	obtempérer	Ver:IPSim+PL+P3
obtempérerez	obtempérer	Ver:IFut+PL+P2
obtempéreriez	obtempérer	Ver:CPre+PL+P2
obtempérerions	obtempérer	Ver:CPre+PL+P1
obtempérer	obtempérer	Ver:Inf
obtempérerons	obtempérer	Ver:IFut+PL+P1
obtempéreront	obtempérer	Ver:IFut+PL+P3
obtempères	obtempérer	Ver:IPre+SG+P2
obtempères	obtempérer	Ver:SPre+SG+P2
obtempérez	obtempérer	Ver:IPre+PL+P2:ImPre+PL+P2
obtempériez	obtempérer	Ver:IImp+PL+P2:SPre+PL+P2
obtempérions	obtempérer	Ver:IImp+PL+P1:SPre+PL+P1
obtempérons	obtempérer	Ver:IPre+PL+P1:ImPre+PL+P1
obtenaient	obtenir	Ver:IImp+PL+P3
obtenais	obtenir	Ver:IImp+SG+P1:IImp+SG+P2
obtenait	obtenir	Ver:IImp+SG+P3
obtenant	obtenir	Ver:PPre
obtenez	obtenir	Ver:IPre+PL+P2:ImPre+PL+P2
obteniez	obtenir	Ver:IImp+PL+P2:SPre+PL+P2
obtenions	obtenir	Ver:IImp+PL+P1:SPre+PL+P1
obtenir	obtenir	Ver:Inf
obtenons	obtenir	Ver:IPre+PL+P1:ImPre+PL+P1
obtention	obtention	Nom:Fem+SG
obtenue	obtenir	Ver:PPas+Fem+SG
obtenues	obtenir	Ver:PPas+Fem+PL
obtenu	obtenir	Ver:PPas+Mas+SG
obtenus	obtenir	Ver:PPas+Mas+PL
obtiendraient	obtenir	Ver:CPre+PL+P3
obtiendrai	obtenir	Ver:IFut+SG+P1
obtiendrais	obtenir	Ver:CPre+SG+P1:CPre+SG+P2
obtiendrait	obtenir	Ver:CPre+SG+P3
obtiendra	obtenir	Ver:IFut+SG+P3
obtiendras	obtenir	Ver:IFut+SG+P2
obtiendrez	obtenir	Ver:IFut+PL+P2
obtiendriez	obtenir	Ver:CPre+PL+P2
obtiendrions	obtenir	Ver:CPre+PL+P1
obtiendrons	obtenir	Ver:IFut+PL+P1
obtiendront	obtenir	Ver:IFut+PL+P3
obtiennent	obtenir	Ver:IPre+PL+P3:SPre+PL+P3
obtienne	obtenir	Ver:SPre+SG+P1:SPre+SG+P3
obtiennes	obtenir	Ver:SPre+SG+P2
obtiens	obtenir	Ver:IPre+SG+P1:IPre+SG+P2:ImPre+SG+P2
obtient	obtenir	Ver:IPre+SG+P3
obtînmes	obtenir	Ver:IPSim+PL+P1
obtinrent	obtenir	Ver:IPSim+PL+P3
obtins	obtenir	Ver:IPSim+SG+P1:IPSim+SG+P2
obtinssent	obtenir	Ver:SImp+PL+P3
obtinsse	obtenir	Ver:SImp+SG+P1
obtinsses	obtenir	Ver:SImp+SG+P2
obtinssiez	obtenir	Ver:SImp+PL+P2
obtinssions	obtenir	Ver:SImp+PL+P1
obtîntes	obtenir	Ver:IPSim+PL+P2
obtint	obtenir	Ver:IPSim+SG+P3
obtînt	obtenir	Ver:SImp+SG+P3
obturaient	obturer	Ver:IImp+PL+P3
obturai	obturer	Ver:IPSim+SG+P1
obturais	obturer	Ver:IImp+SG+P1:IImp+SG+P2
obturait	obturer	Ver:IImp+SG+P3
obturâmes	obturer	Ver:IPSim+PL+P1
obturant	obturer	Ver:PPre
obtura	obturer	Ver:IPSim+SG+P3
obturas	obturer	Ver:IPSim+SG+P2
obturassent	obturer	Ver:SImp+PL+P3
obturasse	obturer	Ver:SImp+SG+P1
obturasses	obturer	Ver:SImp+SG+P2
obturassiez	obturer	Ver:SImp+PL+P2
obturassions	obturer	Ver:SImp+PL+P1
obturâtes	obturer	Ver:IPSim+PL+P2
obturateur	obturateur	Adj:Mas+SG
obturateur	obturateur	Nom:Mas+SG
obturateurs	obturateur	Adj:Mas+PL
obturateurs	obturateur	Nom:Mas+PL
obturation	obturation	Nom:Fem+SG
obturations	obturation	Nom:Fem+PL
obturât	obturer	Ver:SImp+SG+P3
obturatrice	obturateur	Adj:Fem+SG
obturée	obturé	Adj:Fem+SG
obturée	obturer	Ver:PPas+Fem+SG
obturées	obturé	Adj:Fem+PL
obturées	obturer	Ver:PPas+Fem+PL
obturent	obturer	Ver:IPre+PL+P3:SPre+PL+P3
obturé	obturé	Adj:Mas+SG
obture	obturer	Ver:IPre+SG+P1:IPre+SG+P3:SPre+SG+P1:SPre+SG+P3:ImPre+SG+P2
obturé	obturer	Ver:PPas+Mas+SG
obtureraient	obturer	Ver:CPre+PL+P3
obturerai	obturer	Ver:IFut+SG+P1
obturerais	obturer	Ver:CPre+SG+P1:CPre+SG+P2
obturerait	obturer	Ver:CPre+SG+P3
obturera	obturer	Ver:IFut+SG+P3
obtureras	obturer	Ver:IFut+SG+P2
obturèrent	obturer	Ver:IPSim+PL+P3
obturerez	obturer	Ver:IFut+PL+P2
obtureriez	obturer	Ver:CPre+PL+P2
obturerions	obturer	Ver:CPre+PL+P1
obturer	obturer	Ver:Inf
obturerons	obturer	Ver:IFut+PL+P1
obtureront	obturer	Ver:IFut+PL+P3
obturés	obturé	Adj:Mas+PL
obtures	obturer	Ver:IPre+SG+P2:SPre+SG+P2
obturés	obturer	Ver:PPas+Mas+PL
obturez	obturer	Ver:IPre+PL+P2:ImPre+PL+P2
obturiez	obturer	Ver:IImp+PL+P2:SPre+PL+P2
obturions	obturer	Ver:IImp+PL+P1:SPre+PL+P1
obturons	obturer	Ver:IPre+PL+P1:ImPre+PL+P1
obtusangle	obtusangle	Adj:InvGen+SG
obtuse	obtus	Adj:Fem+SG
obtuses	obtus	Adj:Fem+PL
obtusion	obtusion	Nom:Fem+SG
obtus	obtus	Adj:Mas+InvPL
obusier	obusier	Nom:Mas+SG
obusiers	obusier	Nom:Mas+PL
obus	obus	Nom:Mas+InvPL
obvenaient	obvenir	Ver:IImp+PL+P3
obvenais	obvenir	Ver:IImp+SG+P1:IImp+SG+P2
obvenait	obvenir	Ver:IImp+SG+P3
obvenant	obvenir	Ver:PPre
obvenez	obvenir	Ver:IPre+PL+P2:ImPre+PL+P2
obveniez	obvenir	Ver:IImp+PL+P2:SPre+PL+P2
obvenions	obvenir	Ver:IImp+PL+P1:SPre+PL+P1
obvenir	obvenir	Ver:Inf
obvenons	obvenir	Ver:IPre+PL+P1:ImPre+PL+P1
obvenue	obvenir	Ver:PPas+Fem+SG
obvenues	obvenir	Ver:PPas+Fem+PL
obvenu	obvenir	Ver:PPas+Mas+SG
obvenus	obvenir	Ver:PPas+Mas+PL
obvers	obvers	Nom:Mas+InvPL
obviaient	obvier	Ver:IImp+PL+P3
obviai	obvier	Ver:IPSim+SG+P1
obviais	obvier	Ver:IImp+SG+P1:IImp+SG+P2
obviait	obvier	Ver:IImp+SG+P3
obviâmes	obvier	Ver:IPSim+PL+P1
obviant	obvier	Ver:PPre
obvia	obvier	Ver:IPSim+SG+P3
obvias	obvier	Ver:IPSim+SG+P2
obviassent	obvier	Ver:SImp+PL+P3
obviasse	obvier	Ver:SImp+SG+P1
obviasses	obvier	Ver:SImp+SG+P2
obviassiez	obvier	Ver:SImp+PL+P2
obviassions	obvier	Ver:SImp+PL+P1
obviâtes	obvier	Ver:IPSim+PL+P2
obviât	obvier	Ver:SImp+SG+P3
obviendraient	obvenir	Ver:CPre+PL+P3
obviendrai	obvenir	Ver:IFut+SG+P1
obviendrais	obvenir	Ver:CPre+SG+P1:CPre+SG+P2
obviendrait	obvenir	Ver:CPre+SG+P3
obviendra	obvenir	Ver:IFut+SG+P3
obviendras	obvenir	Ver:IFut+SG+P2
obviendrez	obvenir	Ver:IFut+PL+P2
obviendriez	obvenir	Ver:CPre+PL+P2
obviendrions	obvenir	Ver:CPre+PL+P1
obviendrons	obvenir	Ver:IFut+PL+P1
obviendront	obvenir	Ver:IFut+PL+P3
obviennent	obvenir	Ver:IPre+PL+P3:SPre+PL+P3
obvienne	obvenir	Ver:SPre+SG+P1:SPre+SG+P3
obviennes	obvenir	Ver:SPre+SG+P2
obviens	obvenir	Ver:IPre+SG+P1:IPre+SG+P2:ImPre+SG+P2
obvient	obvenir	Ver:IPre+SG+P3
obvient	obvier	Ver:IPre+PL+P3:SPre+PL+P3
obvie	obvie	Adj:InvGen+SG
obvie	obvier	Ver:IPre+SG+P1:IPre+SG+P3:SPre+SG+P1:SPre+SG+P3:ImPre+SG+P2
obvié	obvier	Ver:PPas+Mas+SG
obvièrent	obvier	Ver:IPSim+PL+P3
obvier	obvier	Ver:Inf
obvies	obvie	Adj:InvGen+PL
obvies	obvier	Ver:IPre+SG+P2:SPre+SG+P2
obviez	obvier	Ver:IPre+PL+P2:ImPre+PL+P2
obviiez	obvier	Ver:IImp+PL+P2:SPre+PL+P2
obviions	obvier	Ver:IImp+PL+P1:SPre+PL+P1
obvînmes	obvenir	Ver:IPSim+PL+P1
obvins	obvenir	Ver:IPSim+SG+P1:IPSim+SG+P2
obvinssent	obvenir	Ver:SImp+PL+P3
obvinsse	obvenir	Ver:SImp+SG+P1
obvinsses	obvenir	Ver:SImp+SG+P2
obvinssiez	obvenir	Ver:SImp+PL+P2
obvinssions	obvenir	Ver:SImp+PL+P1
obvîntes	obvenir	Ver:IPSim+PL+P2
obvînt	obvenir	Ver:SImp+SG+P3
obvions	obvier	Ver:IPre+PL+P1:ImPre+PL+P1
ocarina	ocarina	Nom:Mas+SG
ocarinas	ocarina	Nom:Mas+PL
occase	occase	Adj:Fem+SG
occase	occase	Nom:Fem+SG
occasionnaient	occasionner	Ver:IImp+PL+P3
occasionnai	occasionner	Ver:IPSim+SG+P1
occasionnais	occasionner	Ver:IImp+SG+P1:IImp+SG+P2
occasionnait	occasionner	Ver:IImp+SG+P3
occasionnalisme	occasionnalisme	Nom:Mas+SG
occasionnâmes	occasionner	Ver:IPSim+PL+P1
occasionnant	occasionner	Ver:PPre
occasionna	occasionner	Ver:IPSim+SG+P3
occasionnas	occasionner	Ver:IPSim+SG+P2
occasionnassent	occasionner	Ver:SImp+PL+P3
occasionnasse	occasionner	Ver:SImp+SG+P1
occasionnasses	occasionner	Ver:SImp+SG+P2
occasionnassiez	occasionner	Ver:SImp+PL+P2
occasionnassions	occasionner	Ver:SImp+PL+P1
occasionnâtes	occasionner	Ver:IPSim+PL+P2
occasionnât	occasionner	Ver:SImp+SG+P3
occasionnée	occasionner	Ver:PPas+Fem+SG
occasionnées	occasionner	Ver:PPas+Fem+PL
occasionnellement	occasionnellement	Adv
occasionnelle	occasionnel	Adj:Fem+SG
occasionnelles	occasionnel	Adj:Fem+PL
occasionnel	occasionnel	Adj:Mas+SG
occasionnels	occasionnel	Adj:Mas+PL
occasionnent	occasionner	Ver:IPre+PL+P3
occasionnent	occasionner	Ver:SPre+PL+P3
occasionne	occasionner	Ver:IPre+SG+P1:IPre+SG+P3:SPre+SG+P1:SPre+SG+P3:ImPre+SG+P2
occasionné	occasionner	Ver:PPas+Mas+SG
occasionneraient	occasionner	Ver:CPre+PL+P3
occasionnerai	occasionner	Ver:IFut+SG+P1
occasionnerais	occasionner	Ver:CPre+SG+P1:CPre+SG+P2
occasionnerait	occasionner	Ver:CPre+SG+P3
occasionnera	occasionner	Ver:IFut+SG+P3
occasionneras	occasionner	Ver:IFut+SG+P2
occasionnèrent	occasionner	Ver:IPSim+PL+P3
occasionnerez	occasionner	Ver:IFut+PL+P2
occasionneriez	occasionner	Ver:CPre+PL+P2
occasionnerions	occasionner	Ver:CPre+PL+P1
occasionner	occasionner	Ver:Inf
occasionnerons	occasionner	Ver:IFut+PL+P1
occasionneront	occasionner	Ver:IFut+PL+P3
occasionnes	occasionner	Ver:IPre+SG+P2:SPre+SG+P2
occasionnés	occasionner	Ver:PPas+Mas+PL
occasionnez	occasionner	Ver:IPre+PL+P2:ImPre+PL+P2
occasionniez	occasionner	Ver:IImp+PL+P2:SPre+PL+P2
occasionnions	occasionner	Ver:IImp+PL+P1:SPre+PL+P1
occasionnons	occasionner	Ver:IPre+PL+P1:ImPre+PL+P1
occasion	occasion	Nom:Fem+SG
occasions	occasion	Nom:Fem+PL
occidentale	occidental	Adj:Fem+SG
occidentale	occidental	Nom:Fem+SG
occidentales	occidental	Adj:Fem+PL
occidentales	occidental	Nom:Fem+PL
occidentalisant	occidentaliser	Ver:PPre
occidentalisation	occidentalisation	Nom:Fem+SG
occidentalisations	occidentalisation	Nom:Fem+PL
occidentalisée	occidentaliser	Ver:PPas+Fem+SG
occidentalisées	occidentaliser	Ver:PPas+Fem+PL
occidentalisé	occidentaliser	Ver:PPas+Mas+SG
occidentaliser	occidentaliser	Ver:Inf
occidentalisés	occidentaliser	Ver:PPas+Mas+PL
occidentaliste	occidentaliste	Adj:InvGen+SG
occidentaliste	occidentaliste	Nom:InvGen+SG
occidental	occidental	Adj:Mas+SG
occidental	occidental	Nom:Mas+SG
occidentaux	occidental	Adj:Mas+PL
occidentaux	occidental	Nom:Mas+PL
occident	occident	Nom:Mas+SG
occipitale	occipital	Adj:Fem+SG
occipitales	occipital	Adj:Fem+PL
occipital	occipital	Adj:Mas+SG
occipitaux	occipital	Adj:Mas+PL
occiput	occiput	Nom:Mas+SG
occiputs	occiput	Nom:Mas+PL
occire	occire	Ver:Inf
occis	occire	Ver:PPas+Mas+SG:PPas+Mas+PL
occis	occis	Adj:Mas+InvPL
occitane	occitan	Adj:Fem+SG
occitanes	occitan	Adj:Fem+PL
occitan	occitan	Adj:Mas+SG
occluaient	occlure	Ver:IImp+PL+P3
occluais	occlure	Ver:IImp+SG+P1:IImp+SG+P2
occluait	occlure	Ver:IImp+SG+P3
occluant	occlure	Ver:PPre
occluent	occlure	Ver:IPre+PL+P3:SPre+PL+P3
occlue	occlure	Ver:SPre+SG+P1:SPre+SG+P3
occlues	occlure	Ver:SPre+SG+P2
occluez	occlure	Ver:IPre+PL+P2:ImPre+PL+P2
occluiez	occlure	Ver:IImp+PL+P2:SPre+PL+P2
occluions	occlure	Ver:IImp+PL+P1:SPre+PL+P1
occlûmes	occlure	Ver:IPSim+PL+P1
occluons	occlure	Ver:IPre+PL+P1:ImPre+PL+P1
occlurent	occlure	Ver:IPSim+PL+P3
occlure	occlure	Ver:Inf
occlusif	occlusif	Adj:Mas+SG
occlusifs	occlusif	Adj:Mas+PL
occlusion	occlusion	Nom:Fem+SG
occlusions	occlusion	Nom:Fem+PL
occlusive	occlusif	Adj:Fem+SG
occlusive	occlusive	Nom:Fem+SG
occlusives	occlusif	Adj:Fem+PL
occlusives	occlusive	Nom:Fem+PL
occlus	occlure	Ver:PPas+Mas+SG:PPas+Mas+PL:IPre+SG+P1:IPre+SG+P2:ImPre+SG+P2
occlus	occlure	Ver:IPSim+SG+P1:IPSim+SG+P2
occlussent	occlure	Ver:SImp+PL+P3
occlusse	occlure	Ver:SImp+SG+P1
occlusses	occlure	Ver:SImp+SG+P2
occlussiez	occlure	Ver:SImp+PL+P2
occlussions	occlure	Ver:SImp+PL+P1
occlûtes	occlure	Ver:IPSim+PL+P2
occlût	occlure	Ver:SImp+SG+P3
occultaient	occulter	Ver:IImp+PL+P3
occultai	occulter	Ver:IPSim+SG+P1
occultais	occulter	Ver:IImp+SG+P1:IImp+SG+P2
occultait	occulter	Ver:IImp+SG+P3
occultâmes	occulter	Ver:IPSim+PL+P1
occultant	occulter	Ver:PPre
occulta	occulter	Ver:IPSim+SG+P3
occultas	occulter	Ver:IPSim+SG+P2
occultassent	occulter	Ver:SImp+PL+P3
occultasse	occulter	Ver:SImp+SG+P1
occultasses	occulter	Ver:SImp+SG+P2
occultassiez	occulter	Ver:SImp+PL+P2
occultassions	occulter	Ver:SImp+PL+P1
occultâtes	occulter	Ver:IPSim+PL+P2
occultation	occultation	Nom:Fem+SG
occultations	occultation	Nom:Fem+PL
occultât	occulter	Ver:SImp+SG+P3
occultée	occulter	Ver:PPas+Fem+SG
occultées	occulter	Ver:PPas+Fem+PL
occultement	occultement	Adv
occultent	occulter	Ver:IPre+PL+P3
occultent	occulter	Ver:SPre+PL+P3
occulte	occulte	Adj:InvGen+SG
occulte	occulter	Ver:Imp+SG+P2
occulte	occulter	Ver:IPre+SG+P1
occulte	occulter	Ver:IPre+SG+P3
occulté	occulter	Ver:PPas+Mas+SG
occulte	occulter	Ver:SPre+SG+P1
occulte	occulter	Ver:SPre+SG+P3
occulteraient	occulter	Ver:CPre+PL+P3
occulterai	occulter	Ver:IFut+SG+P1
occulterais	occulter	Ver:CPre+SG+P1:CPre+SG+P2
occulterait	occulter	Ver:CPre+SG+P3
occultera	occulter	Ver:IFut+SG+P3
occulteras	occulter	Ver:IFut+SG+P2
occultèrent	occulter	Ver:IPSim+PL+P3
occulterez	occulter	Ver:IFut+PL+P2
occulteriez	occulter	Ver:CPre+PL+P2
occulterions	occulter	Ver:CPre+PL+P1
occulter	occulter	Ver:Inf
occulterons	occulter	Ver:IFut+PL+P1
occulteront	occulter	Ver:IFut+PL+P3
occultes	occulte	Adj:InvGen+PL
occultes	occulter	Ver:IPre+SG+P2
occultés	occulter	Ver:PPas+Mas+PL
occultes	occulter	Ver:SPre+SG+P2
occultez	occulter	Ver:IPre+PL+P2:ImPre+PL+P2
occultiez	occulter	Ver:IImp+PL+P2:SPre+PL+P2
occultions	occulter	Ver:IImp+PL+P1:SPre+PL+P1
occultisme	occultisme	Nom:Mas+SG
occultiste	occultiste	Adj:InvGen+SG
occultiste	occultiste	Nom:InvGen+SG
occultistes	occultiste	Adj:InvGen+PL
occultistes	occultiste	Nom:InvGen+PL
occultons	occulter	Ver:IPre+PL+P1:ImPre+PL+P1
occupaient	occuper	Ver:IImp+PL+P3
occupai	occuper	Ver:IPSim+SG+P1
occupais	occuper	Ver:IImp+SG+P1:IImp+SG+P2
occupait	occuper	Ver:IImp+SG+P3
occupâmes	occuper	Ver:IPSim+PL+P1
occupante	occupant	Adj:Fem+SG
occupante	occupant	Nom:Fem+SG
occupantes	occupant	Adj:Fem+PL
occupantes	occupant	Nom:Fem+PL
occupant	occupant	Adj:Mas+SG
occupant	occupant	Nom:Mas+SG
occupant	occuper	Ver:PPre
occupants	occupant	Adj:Mas+PL
occupants	occupant	Nom:Mas+PL
occupa	occuper	Ver:IPSim+SG+P3
occupas	occuper	Ver:IPSim+SG+P2
occupassent	occuper	Ver:SImp+PL+P3
occupasse	occuper	Ver:SImp+SG+P1
occupasses	occuper	Ver:SImp+SG+P2
occupassiez	occuper	Ver:SImp+PL+P2
occupassions	occuper	Ver:SImp+PL+P1
occupâtes	occuper	Ver:IPSim+PL+P2
occupationnel	occupationnel	Adj:Mas+SG
occupation	occupation	Nom:Fem+SG
occupations	occupation	Nom:Fem+PL
occupât	occuper	Ver:SImp+SG+P3
occupée	occupé	Adj:Fem+SG
occupée	occuper	Ver:PPas+Fem+SG
occupées	occupé	Adj:Fem+PL
occupées	occuper	Ver:PPas+Fem+PL
occupent	occuper	Ver:IPre+PL+P3:SPre+PL+P3
occupé	occupé	Adj:Mas+SG
occupe	occuper	Ver:IPre+SG+P1:IPre+SG+P3:SPre+SG+P1:SPre+SG+P3:ImPre+SG+P2
occupé	occuper	Ver:PPas+Mas+SG
occuperaient	occuper	Ver:CPre+PL+P3
occuperai	occuper	Ver:IFut+SG+P1
occuperais	occuper	Ver:CPre+SG+P1:CPre+SG+P2
occuperait	occuper	Ver:CPre+SG+P3
occupera	occuper	Ver:IFut+SG+P3
occuperas	occuper	Ver:IFut+SG+P2
occupèrent	occuper	Ver:IPSim+PL+P3
occuperez	occuper	Ver:IFut+PL+P2
occuperiez	occuper	Ver:CPre+PL+P2
occuperions	occuper	Ver:CPre+PL+P1
occuper	occuper	Ver:Inf
occuperons	occuper	Ver:IFut+PL+P1
occuperont	occuper	Ver:IFut+PL+P3
occupés	occupé	Adj:Mas+PL
occupes	occuper	Ver:IPre+SG+P2:SPre+SG+P2
occupés	occuper	Ver:PPas+Mas+PL
occupez	occuper	Ver:IPre+PL+P2:ImPre+PL+P2
occupiez	occuper	Ver:IImp+PL+P2:SPre+PL+P2
occupions	occuper	Ver:IImp+PL+P1:SPre+PL+P1
occupons	occuper	Ver:IPre+PL+P1:ImPre+PL+P1
occurrence	occurrence	Nom:Fem+SG
occurrences	occurrence	Nom:Fem+PL
occurrente	occurrent	Adj:Fem+SG
occurrentes	occurrent	Adj:Fem+PL
occurrent	occurrent	Adj:Mas+SG
océanaute	océanaute	Nom:InvGen+SG
océanide	océanide	Nom:Fem+SG
océanienne	océanien	Adj:Fem+SG
océanienne	océanien	Nom:Fem+SG
océaniennes	océanien	Adj:Fem+PL
océaniennes	océanien	Nom:Fem+PL
océanien	océanien	Adj:Mas+SG
océanien	océanien	Nom:Mas+SG
océaniens	océanien	Adj:Mas+PL
océanique	océanique	Adj:InvGen+SG
océaniques	océanique	Adj:InvGen+PL
océan	océan	Nom:Mas+SG
océanographe	océanographe	Nom:InvGen+SG
océanographes	océanographe	Nom:InvGen+PL
océanographie	océanographie	Nom:Fem+SG
océanographique	océanographique	Adj:InvGen+SG
océanographiques	océanographique	Adj:InvGen+PL
océanologie	océanologie	Nom:Fem+SG
océanologique	océanologique	Adj:InvGen+SG
océanologiques	océanologique	Adj:InvGen+PL
océanologue	océanologue	Nom:InvGen+SG
océanologues	océanologue	Nom:InvGen+PL
océans	océan	Nom:Mas+PL
ocellée	ocellé	Adj:Fem+SG
ocellées	ocellé	Adj:Fem+PL
ocellé	ocellé	Adj:Mas+SG
ocelle	ocelle	Nom:Mas+SG
ocelle	oceller	Ver:IPre+SG+P1:IPre+SG+P3:SPre+SG+P1:SPre+SG+P3:ImPre+SG+P2
ocelot	ocelot	Nom:Mas+SG
ocelots	ocelot	Nom:Mas+PL
oc	oc	Nom:Fem+SG
ocraient	ocrer	Ver:IImp+PL+P3
ocrai	ocrer	Ver:IPSim+SG+P1
ocrais	ocrer	Ver:IImp+SG+P1:IImp+SG+P2
ocrait	ocrer	Ver:IImp+SG+P3
ocrâmes	ocrer	Ver:IPSim+PL+P1
ocrant	ocrer	Ver:PPre
ocra	ocrer	Ver:IPSim+SG+P3
ocras	ocrer	Ver:IPSim+SG+P2
ocrassent	ocrer	Ver:SImp+PL+P3
ocrasse	ocrer	Ver:SImp+SG+P1
ocrasses	ocrer	Ver:SImp+SG+P2
ocrassiez	ocrer	Ver:SImp+PL+P2
ocrassions	ocrer	Ver:SImp+PL+P1
ocrâtes	ocrer	Ver:IPSim+PL+P2
ocrât	ocrer	Ver:SImp+SG+P3
ocrent	ocrer	Ver:IPre+PL+P3:SPre+PL+P3
ocre	ocre	Adj:InvGen+SG:InvGen+PL
ocré	ocré	Adj:Mas+SG
ocre	ocre	Nom:Fem+SG
ocre	ocre	Nom:Mas+SG
ocre	ocrer	Ver:IPre+SG+P1:IPre+SG+P3:SPre+SG+P1:SPre+SG+P3:ImPre+SG+P2
ocré	ocrer	Ver:PPas+Mas+SG
ocreraient	ocrer	Ver:CPre+PL+P3
ocrerai	ocrer	Ver:IFut+SG+P1
ocrerais	ocrer	Ver:CPre+SG+P1:CPre+SG+P2
ocrerait	ocrer	Ver:CPre+SG+P3
ocrera	ocrer	Ver:IFut+SG+P3
ocreras	ocrer	Ver:IFut+SG+P2
ocrèrent	ocrer	Ver:IPSim+PL+P3
ocrerez	ocrer	Ver:IFut+PL+P2
ocreriez	ocrer	Ver:CPre+PL+P2
ocrerions	ocrer	Ver:CPre+PL+P1
ocrer	ocrer	Ver:Inf
ocrerons	ocrer	Ver:IFut+PL+P1
ocreront	ocrer	Ver:IFut+PL+P3
ocres	ocre	Nom:Fem+PL
ocres	ocre	Nom:Mas+PL
ocres	ocrer	Ver:IPre+SG+P2:SPre+SG+P2
ocreuse	ocreux	Adj:Fem+SG
ocreuses	ocreux	Adj:Fem+PL
ocreux	ocreux	Adj:Mas+InvPL
ocrez	ocrer	Ver:IPre+PL+P2:ImPre+PL+P2
ocriez	ocrer	Ver:IImp+PL+P2:SPre+PL+P2
ocrions	ocrer	Ver:IImp+PL+P1:SPre+PL+P1
ocrons	ocrer	Ver:IPre+PL+P1:ImPre+PL+P1
octaèdre	octaèdre	Nom:Mas+SG
octale	octal	Adj:Fem+SG
octales	octal	Adj:Fem+PL
octal	octal	Adj:Mas+SG
octal	octal	Nom:Mas+SG
octane	octane	Nom:Mas+SG
octante	octante	Det:InvGen+PL
octant	octant	Nom:Mas+SG
octaux	octal	Adj:Mas+PL
octaux	octal	Nom:Mas+PL
octave	octave	Nom:Fem+SG
octaves	octave	Nom:Fem+PL
octaviaient	octavier	Ver:IImp+PL+P3
octaviai	octavier	Ver:IPSim+SG+P1
octaviais	octavier	Ver:IImp+SG+P1:IImp+SG+P2
octaviait	octavier	Ver:IImp+SG+P3
octaviâmes	octavier	Ver:IPSim+PL+P1
octaviant	octavier	Ver:PPre
octavia	octavier	Ver:IPSim+SG+P3
octavias	octavier	Ver:IPSim+SG+P2
octaviassent	octavier	Ver:SImp+PL+P3
octaviasse	octavier	Ver:SImp+SG+P1
octaviasses	octavier	Ver:SImp+SG+P2
octaviassiez	octavier	Ver:SImp+PL+P2
octaviassions	octavier	Ver:SImp+PL+P1
octaviâtes	octavier	Ver:IPSim+PL+P2
octaviât	octavier	Ver:SImp+SG+P3
octavien	octavien	Adj:Mas+SG
octavient	octavier	Ver:IPre+PL+P3:SPre+PL+P3
octavie	octavier	Ver:IPre+SG+P1:IPre+SG+P3:SPre+SG+P1:SPre+SG+P3:ImPre+SG+P2
octavié	octavier	Ver:PPas+Mas+SG
octavièrent	octavier	Ver:IPSim+PL+P3
octavier	octavier	Ver:Inf
octavies	octavier	Ver:IPre+SG+P2:SPre+SG+P2
octaviez	octavier	Ver:IPre+PL+P2:ImPre+PL+P2
octaviiez	octavier	Ver:IImp+PL+P2:SPre+PL+P2
octaviions	octavier	Ver:IImp+PL+P1:SPre+PL+P1
octavin	octavin	Nom:Mas+SG
octavions	octavier	Ver:IPre+PL+P1:ImPre+PL+P1
octavo	octavo	Adv
octet	octet	Nom:Mas+SG
octets	octet	Nom:Mas+PL
octidi	octidi	Nom:Mas+SG
octobre	octobre	Nom:Mas+SG
octobres	octobre	Nom:Mas+PL
octocoralliaire	octocoralliaire	Nom:Mas+SG
octocoralliaires	octocoralliaire	Nom:Mas+PL
oct	oct	Abr
octogénaire	octogénaire	Adj:InvGen+SG
octogénaire	octogénaire	Nom:InvGen+SG
octogénaires	octogénaire	Adj:InvGen+PL
octogénaires	octogénaire	Nom:InvGen+PL
octogonale	octogonal	Adj:Fem+SG
octogonales	octogonal	Adj:Fem+PL
octogonal	octogonal	Adj:Mas+SG
octogonaux	octogonal	Adj:Mas+PL
octogone	octogone	Adj:InvGen+SG
octogone	octogone	Nom:Mas+SG
octogones	octogone	Adj:InvGen+PL
octogones	octogone	Nom:Mas+PL
octopode	octopode	Adj:InvGen+SG
octostyle	octostyle	Adj:InvGen+SG
octosyllabe	octosyllabe	Adj:InvGen+SG
octosyllabique	octosyllabique	Adj:InvGen+SG
octroient	octroyer	Ver:IPre+PL+P3:SPre+PL+P3
octroie	octroyer	Ver:IPre+SG+P1:IPre+SG+P3:SPre+SG+P1:SPre+SG+P3:ImPre+SG+P2
octroieraient	octroyer	Ver:CPre+PL+P3
octroierai	octroyer	Ver:IFut+SG+P1
octroierais	octroyer	Ver:CPre+SG+P1:CPre+SG+P2
octroierait	octroyer	Ver:CPre+SG+P3
octroiera	octroyer	Ver:IFut+SG+P3
octroieras	octroyer	Ver:IFut+SG+P2
octroierez	octroyer	Ver:IFut+PL+P2
octroieriez	octroyer	Ver:CPre+PL+P2
octroierions	octroyer	Ver:CPre+PL+P1
octroierons	octroyer	Ver:IFut+PL+P1
octroieront	octroyer	Ver:IFut+PL+P3
octroies	octroyer	Ver:IPre+SG+P2:SPre+SG+P2
octroi	octroi	Nom:Mas+SG
octrois	octroi	Nom:Mas+PL
octroyaient	octroyer	Ver:IImp+PL+P3
octroyai	octroyer	Ver:IPSim+SG+P1
octroyais	octroyer	Ver:IImp+SG+P1:IImp+SG+P2
octroyait	octroyer	Ver:IImp+SG+P3
octroyâmes	octroyer	Ver:IPSim+PL+P1
octroyant	octroyer	Ver:PPre
octroya	octroyer	Ver:IPSim+SG+P3
octroyas	octroyer	Ver:IPSim+SG+P2
octroyassent	octroyer	Ver:SImp+PL+P3
octroyasse	octroyer	Ver:SImp+SG+P1
octroyasses	octroyer	Ver:SImp+SG+P2
octroyassiez	octroyer	Ver:SImp+PL+P2
octroyassions	octroyer	Ver:SImp+PL+P1
octroyâtes	octroyer	Ver:IPSim+PL+P2
octroyât	octroyer	Ver:SImp+SG+P3
octroyée	octroyer	Ver:PPas+Fem+SG
octroyées	octroyer	Ver:PPas+Fem+PL
octroyé	octroyer	Ver:PPas+Mas+SG
octroyèrent	octroyer	Ver:IPSim+PL+P3
octroyer	octroyer	Ver:Inf
octroyés	octroyer	Ver:PPas+Mas+PL
octroyez	octroyer	Ver:IPre+PL+P2:ImPre+PL+P2
octroyiez	octroyer	Ver:IImp+PL+P2:SPre+PL+P2
octroyions	octroyer	Ver:IImp+PL+P1:SPre+PL+P1
octroyons	octroyer	Ver:IPre+PL+P1:ImPre+PL+P1
octuor	octuor	Nom:Mas+SG
octuplaient	octupler	Ver:IImp+PL+P3
octuplai	octupler	Ver:IPSim+SG+P1
octuplais	octupler	Ver:IImp+SG+P1:IImp+SG+P2
octuplait	octupler	Ver:IImp+SG+P3
octuplâmes	octupler	Ver:IPSim+PL+P1
octuplant	octupler	Ver:PPre
octupla	octupler	Ver:IPSim+SG+P3
octuplas	octupler	Ver:IPSim+SG+P2
octuplassent	octupler	Ver:SImp+PL+P3
octuplasse	octupler	Ver:SImp+SG+P1
octuplasses	octupler	Ver:SImp+SG+P2
octuplassiez	octupler	Ver:SImp+PL+P2
octuplassions	octupler	Ver:SImp+PL+P1
octuplâtes	octupler	Ver:IPSim+PL+P2
octuplât	octupler	Ver:SImp+SG+P3
octuplent	octupler	Ver:IPre+PL+P3:SPre+PL+P3
octuple	octuple	Adj:InvGen+SG
octuple	octuple	Nom:Mas+SG
octuple	octupler	Ver:IPre+SG+P1:IPre+SG+P3:SPre+SG+P1:SPre+SG+P3:ImPre+SG+P2
octuplé	octupler	Ver:PPas+Mas+SG
octuplèrent	octupler	Ver:IPSim+PL+P3
octupler	octupler	Ver:Inf
octuples	octuple	Adj:InvGen+PL
octuples	octuple	Nom:Mas+PL
octuples	octupler	Ver:IPre+SG+P2:SPre+SG+P2
octuplez	octupler	Ver:IPre+PL+P2:ImPre+PL+P2
octupliez	octupler	Ver:IImp+PL+P2:SPre+PL+P2
octuplions	octupler	Ver:IImp+PL+P1:SPre+PL+P1
octuplons	octupler	Ver:IPre+PL+P1:ImPre+PL+P1
oculaire	oculaire	Adj:InvGen+SG
oculaire	oculaire	Nom:Mas+SG
oculaires	oculaire	Adj:InvGen+PL
oculaires	oculaire	Nom:Mas+PL
oculariste	oculariste	Nom:InvGen+SG
oculi	oculus	Nom:Mas+PL
oculiste	oculiste	Adj:InvGen+SG
oculiste	oculiste	Nom:InvGen+SG
oculistes	oculiste	Adj:InvGen+PL
oculistes	oculiste	Nom:InvGen+PL
oculistique	oculistique	Adj:InvGen+SG
oculogyre	oculogyre	Adj:InvGen+SG
oculomoteur	oculomoteur	Adj:Mas+SG
oculomotrice	oculomoteur	Adj:Fem+SG
oculus	oculus	Nom:Mas+SG
ocytocine	ocytocine	Nom:Fem+SG
odalisque	odalisque	Nom:Fem+SG
odalisques	odalisque	Nom:Fem+PL
odelette	odelette	Nom:Fem+SG
ode	ode	Nom:Fem+SG
odéon	odéon	Nom:Mas+SG
odes	ode	Nom:Fem+PL
odeur	odeur	Nom:Fem+SG
odeurs	odeur	Nom:Fem+PL
odieusement	odieusement	Adv
odieuse	odieux	Adj:Fem+SG
odieuses	odieux	Adj:Fem+PL
odieux	odieux	Adj:Mas+InvPL
odomètre	odomètre	Nom:Mas+SG
odonate	odonate	Nom:Mas+SG
odonates	odonate	Nom:Mas+PL
odontalgie	odontalgie	Nom:Fem+SG
odontalgique	odontalgique	Adj:InvGen+SG
odontoïde	odontoïde	Adj:InvGen+SG
odontoïde	odontoïde	Nom:Fem+SG
odontoïde	odontoïde	Nom:Mas+SG
odontologie	odontologie	Nom:Fem+SG
odontologiste	odontologiste	Nom:InvGen+SG
odontomètre	odontomètre	Nom:Mas+SG
odontostomatologie	odontostomatologie	Nom:Fem+SG
odorante	odorant	Adj:Fem+SG
odorantes	odorant	Adj:Fem+PL
odorant	odorant	Adj:Mas+SG
odorant	odorer	Ver:PPre
odorants	odorant	Adj:Mas+PL
odorat	odorat	Nom:Mas+SG
odorats	odorat	Nom:Mas+PL
odoriférante	odoriférant	Adj:Fem+SG
odoriférantes	odoriférant	Adj:Fem+PL
odoriférant	odoriférant	Adj:Mas+SG
odoriférants	odoriférant	Adj:Mas+PL
odyssée	odyssée	Nom:Fem+SG
odyssées	odyssée	Nom:Fem+PL
oecuménicité	oecuménicité	Nom:Fem+SG
oecuménique	oecuménique	Adj:InvGen+SG
oecuméniques	oecuménique	Adj:InvGen+PL
oecuménisme	oecuménisme	Nom:Mas+SG
oecuméniste	oecuméniste	Adj:InvGen+SG
oecuméniste	oecuméniste	Nom:InvGen+SG
oedémateuse	oedémateux	Adj:Fem+SG
oedémateuses	oedémateux	Adj:Fem+PL
oedémateux	oedémateux	Adj:Mas+InvPL
oedème	oedème	Nom:Mas+SG
oedèmes	oedème	Nom:Mas+PL
oedicnème	oedicnème	Nom:Mas+SG
oedipe	oedipe	Nom:Mas+SG
oedipienne	oedipien	Adj:Fem+SG
oedipiennes	oedipien	Adj:Fem+PL
oedipien	oedipien	Adj:Mas+SG
oedipiens	oedipien	Adj:Mas+PL
oeillade	oeillade	Nom:Fem+SG
oeillade	oeillader	Ver:IPre+SG+P1:IPre+SG+P3:SPre+SG+P1:SPre+SG+P3:ImPre+SG+P2
oeillades	oeillade	Nom:Fem+PL
oeillades	oeillader	Ver:IPre+SG+P2:SPre+SG+P2
oeillard	oeillard	Nom:Mas+SG
oeillère	oeillère	Nom:Fem+SG
oeillères	oeillère	Nom:Fem+PL
oeillères	oeillères	Nom:Fem+PL
oeillet	oeillet	Nom:Mas+SG
oeilletonnage	oeilletonnage	Nom:Mas+SG
oeilletonnages	oeilletonnage	Nom:Mas+PL
oeilletonnant	oeilletonner	Ver:PPre
oeilletonnent	oeilletonner	Ver:IPre+PL+P3:SPre+PL+P3
oeilletonne	oeilletonner	Ver:IPre+SG+P1:IPre+SG+P3:SPre+SG+P1:SPre+SG+P3:ImPre+SG+P2
oeilletonné	oeilletonner	Ver:PPas+Mas+SG
oeilletonner	oeilletonner	Ver:Inf
oeilletonnes	oeilletonner	Ver:IPre+SG+P2:SPre+SG+P2
oeilleton	oeilleton	Nom:Mas+SG
oeillets	oeillet	Nom:Mas+PL
oeillette	oeillette	Nom:Fem+SG
oeillettes	oeillette	Nom:Fem+PL
oeil	oeil	Nom:Mas+SG
oeils	oeil	Nom:Mas+PL
oeils-de-boeuf	oeil-de-boeuf	Nom:Mas+PL
oeils-de-chat	oeil-de-chat	Nom:Mas+PL
oeils-de-perdrix	oeil-de-perdrix	Nom:Mas+PL
oeil-de-boeuf	oeil-de-boeuf	Nom:Mas+SG
oeil-de-chat	oeil-de-chat	Nom:Mas+SG
oeil-de-perdrix	oeil-de-perdrix	Nom:Mas+SG
oeil-de-pie	oeil-de-pie	Nom:Mas+SG
oekoumène	oekoumène	Nom:Mas+SG
oenanthe	oenanthe	Nom:Fem+SG
oenanthique	oenanthique	Adj:InvGen+SG
oenilisme	oenilisme	Nom:Mas+SG
oenolique	oenolique	Adj:InvGen+SG
oenolisme	oenolisme	Nom:Mas+SG
oenologie	oenologie	Nom:Fem+SG
oenologique	oenologique	Adj:InvGen+SG
oenologue	oenologue	Nom:InvGen+SG
oenologues	oenologue	Nom:InvGen+PL
oenométrie	oenométrie	Nom:Fem+SG
oenométrique	oenométrique	Adj:InvGen+SG
oenothèque	oenothèque	Nom:Fem+SG
oenothéracée	oenothéracée	Nom:Fem+SG
oenothéracées	oenothéracée	Nom:Fem+PL
oenothera	oenothera	Nom:Mas+SG
oenothère	oenothère	Nom:Mas+SG
oersted	oersted	Nom:Mas+SG
oerstite	oerstite	Nom:Fem+SG
oesophage	oesophage	Nom:Mas+SG
oesophages	oesophage	Nom:Mas+PL
oesophagienne	oesophagien	Adj:Fem+SG
oesophagiennes	oesophagien	Adj:Fem+PL
oesophagien	oesophagien	Adj:Mas+SG
oesophagique	oesophagique	Adj:InvGen+SG
oesophagite	oesophagite	Nom:Fem+SG
oesophagoscope	oesophagoscope	Nom:Mas+SG
oestradiol	oestradiol	Nom:Mas+SG
oestrale	oestral	Adj:Fem+SG
oestrales	oestral	Adj:Fem+PL
oestral	oestral	Adj:Mas+SG
oestraux	oestral	Adj:Mas+PL
oestre	oestre	Nom:Mas+SG
oestrogène	oestrogène	Adj:InvGen+SG
oestrogène	oestrogène	Nom:Mas+SG
oestrogènes	oestrogène	Adj:InvGen+PL
oestrogènes	oestrogène	Nom:Mas+PL
oestrone	oestrone	Nom:Fem+SG
oestrus	oestrus	Nom:Mas+InvPL
oeuf	oeuf	Nom:Mas+SG
oeufrier	oeufrier	Nom:Mas+SG
oeufs	oeuf	Nom:Mas+PL
oeuvée	oeuvé	Adj:Fem+SG
oeuvées	oeuvé	Adj:Fem+PL
oeuvé	oeuvé	Adj:Mas+SG
oeuvraient	oeuvrer	Ver:IImp+PL+P3
oeuvrai	oeuvrer	Ver:IPSim+SG+P1
oeuvrais	oeuvrer	Ver:IImp+SG+P1:IImp+SG+P2
oeuvrait	oeuvrer	Ver:IImp+SG+P3
oeuvrâmes	oeuvrer	Ver:IPSim+PL+P1
oeuvrant	oeuvrer	Ver:PPre
oeuvra	oeuvrer	Ver:IPSim+SG+P3
oeuvras	oeuvrer	Ver:IPSim+SG+P2
oeuvrassent	oeuvrer	Ver:SImp+PL+P3
oeuvrasse	oeuvrer	Ver:SImp+SG+P1
oeuvrasses	oeuvrer	Ver:SImp+SG+P2
oeuvrassiez	oeuvrer	Ver:SImp+PL+P2
oeuvrassions	oeuvrer	Ver:SImp+PL+P1
oeuvrâtes	oeuvrer	Ver:IPSim+PL+P2
oeuvrât	oeuvrer	Ver:SImp+SG+P3
oeuvrée	oeuvrée	Nom:Fem+SG
oeuvrée	oeuvrer	Ver:PPas+Fem+SG
oeuvrées	oeuvrée	Nom:Fem+PL
oeuvrées	oeuvrer	Ver:PPas+Fem+PL
oeuvrent	oeuvrer	Ver:IPre+PL+P3:SPre+PL+P3
oeuvre	oeuvre	Nom:Fem+SG
oeuvre	oeuvre	Nom:Mas+SG
oeuvre	oeuvrer	Ver:IPre+SG+P1:IPre+SG+P3:SPre+SG+P1:SPre+SG+P3:ImPre+SG+P2
oeuvré	oeuvrer	Ver:PPas+Mas+SG
oeuvreraient	oeuvrer	Ver:CPre+PL+P3
oeuvrerai	oeuvrer	Ver:IFut+SG+P1
oeuvrerais	oeuvrer	Ver:CPre+SG+P1:CPre+SG+P2
oeuvrerait	oeuvrer	Ver:CPre+SG+P3
oeuvrera	oeuvrer	Ver:IFut+SG+P3
oeuvreras	oeuvrer	Ver:IFut+SG+P2
oeuvrèrent	oeuvrer	Ver:IPSim+PL+P3
oeuvrerez	oeuvrer	Ver:IFut+PL+P2
oeuvreriez	oeuvrer	Ver:CPre+PL+P2
oeuvrerions	oeuvrer	Ver:CPre+PL+P1
oeuvrer	oeuvrer	Ver:Inf
oeuvrerons	oeuvrer	Ver:IFut+PL+P1
oeuvreront	oeuvrer	Ver:IFut+PL+P3
oeuvres	oeuvre	Nom:Fem+PL
oeuvres	oeuvre	Nom:Mas+PL
oeuvres	oeuvrer	Ver:IPre+SG+P2:SPre+SG+P2
oeuvrés	oeuvrer	Ver:PPas+Mas+PL
oeuvres	oeuvres	Nom:Fem+PL
oeuvrez	oeuvrer	Ver:IPre+PL+P2:ImPre+PL+P2
oeuvriez	oeuvrer	Ver:IImp+PL+P2:SPre+PL+P2
oeuvrions	oeuvrer	Ver:IImp+PL+P1:SPre+PL+P1
oeuvrons	oeuvrer	Ver:IPre+PL+P1:ImPre+PL+P1
offensaient	offenser	Ver:IImp+PL+P3
offensai	offenser	Ver:IPSim+SG+P1
offensais	offenser	Ver:IImp+SG+P1:IImp+SG+P2
offensait	offenser	Ver:IImp+SG+P3
offensâmes	offenser	Ver:IPSim+PL+P1
offensante	offensant	Adj:Fem+SG
offensantes	offensant	Adj:Fem+PL
offensant	offensant	Adj:Mas+SG
offensant	offenser	Ver:PPre
offensants	offensant	Adj:Mas+PL
offensa	offenser	Ver:IPSim+SG+P3
offensas	offenser	Ver:IPSim+SG+P2
offensassent	offenser	Ver:SImp+PL+P3
offensasse	offenser	Ver:SImp+SG+P1
offensasses	offenser	Ver:SImp+SG+P2
offensassiez	offenser	Ver:SImp+PL+P2
offensassions	offenser	Ver:SImp+PL+P1
offensâtes	offenser	Ver:IPSim+PL+P2
offensât	offenser	Ver:SImp+SG+P3
offensée	offensé	Adj:Fem+SG
offensée	offensé	Nom:Fem+SG
offensée	offenser	Ver:PPas+Fem+SG
offensées	offensé	Adj:Fem+PL
offensées	offensé	Nom:Fem+PL
offensées	offenser	Ver:PPas+Fem+PL
offensent	offenser	Ver:IPre+PL+P3:SPre+PL+P3
offensé	offensé	Adj:Mas+SG
offense	offense	Nom:Fem+SG
offensé	offensé	Nom:Mas+SG
offense	offenser	Ver:IPre+SG+P1:IPre+SG+P3:SPre+SG+P1:SPre+SG+P3:ImPre+SG+P2
offensé	offenser	Ver:PPas+Mas+SG
offenseraient	offenser	Ver:CPre+PL+P3
offenserai	offenser	Ver:IFut+SG+P1
offenserais	offenser	Ver:CPre+SG+P1:CPre+SG+P2
offenserait	offenser	Ver:CPre+SG+P3
offensera	offenser	Ver:IFut+SG+P3
offenseras	offenser	Ver:IFut+SG+P2
offensèrent	offenser	Ver:IPSim+PL+P3
offenserez	offenser	Ver:IFut+PL+P2
offenseriez	offenser	Ver:CPre+PL+P2
offenserions	offenser	Ver:CPre+PL+P1
offenser	offenser	Ver:Inf
offenserons	offenser	Ver:IFut+PL+P1
offenseront	offenser	Ver:IFut+PL+P3
offensés	offensé	Adj:Mas+PL
offenses	offense	Nom:Fem+PL
offensés	offensé	Nom:Mas+PL
offenses	offenser	Ver:IPre+SG+P2:SPre+SG+P2
offensés	offenser	Ver:PPas+Mas+PL
offenseur	offenseur	Nom:Mas+SG
offenseurs	offenseur	Nom:Mas+PL
offensez	offenser	Ver:IPre+PL+P2:ImPre+PL+P2
offensiez	offenser	Ver:IImp+PL+P2:SPre+PL+P2
offensif	offensif	Adj:Mas+SG
offensifs	offensif	Adj:Mas+PL
offensions	offenser	Ver:IImp+PL+P1:SPre+PL+P1
offensivement	offensivement	Adv
offensive	offensif	Adj:Fem+SG
offensive	offensive	Nom:Fem+SG
offensives	offensif	Adj:Fem+PL
offensives	offensive	Nom:Fem+PL
offensons	offenser	Ver:IPre+PL+P1:ImPre+PL+P1
offerte	offrir	Ver:PPas+Fem+SG
offertes	offrir	Ver:PPas+Fem+PL
offert	offrir	Ver:PPas+Mas+SG
offertoire	offertoire	Nom:Mas+SG
offerts	offrir	Ver:PPas+Mas+PL
office	office	Nom:Fem+SG
office	office	Nom:Mas+SG
offices	office	Nom:Fem+PL
offices	office	Nom:Mas+PL
offices	offices	Nom:Mas+PL
officialisaient	officialiser	Ver:IImp+PL+P3
officialisai	officialiser	Ver:IPSim+SG+P1
officialisais	officialiser	Ver:IImp+SG+P1:IImp+SG+P2
officialisait	officialiser	Ver:IImp+SG+P3
officialisâmes	officialiser	Ver:IPSim+PL+P1
officialisant	officialiser	Ver:PPre
officialisa	officialiser	Ver:IPSim+SG+P3
officialisas	officialiser	Ver:IPSim+SG+P2
officialisassent	officialiser	Ver:SImp+PL+P3
officialisasse	officialiser	Ver:SImp+SG+P1
officialisasses	officialiser	Ver:SImp+SG+P2
officialisassiez	officialiser	Ver:SImp+PL+P2
officialisassions	officialiser	Ver:SImp+PL+P1
officialisâtes	officialiser	Ver:IPSim+PL+P2
officialisation	officialisation	Nom:Fem+SG
officialisations	officialisation	Nom:Fem+PL
officialisât	officialiser	Ver:SImp+SG+P3
officialisée	officialiser	Ver:PPas+Fem+SG
officialisées	officialiser	Ver:PPas+Fem+PL
officialisent	officialiser	Ver:IPre+PL+P3
officialisent	officialiser	Ver:SPre+PL+P3
officialise	officialiser	Ver:Imp+SG+P2
officialise	officialiser	Ver:IPre+SG+P1
officialise	officialiser	Ver:IPre+SG+P3
officialisé	officialiser	Ver:PPas+Mas+SG
officialise	officialiser	Ver:SPre+SG+P1
officialise	officialiser	Ver:SPre+SG+P3
officialiseraient	officialiser	Ver:CPre+PL+P3
officialiserai	officialiser	Ver:IFut+SG+P1
officialiserais	officialiser	Ver:CPre+SG+P1:CPre+SG+P2
officialiserait	officialiser	Ver:CPre+SG+P3
officialisera	officialiser	Ver:IFut+SG+P3
officialiseras	officialiser	Ver:IFut+SG+P2
officialisèrent	officialiser	Ver:IPSim+PL+P3
officialiserez	officialiser	Ver:IFut+PL+P2
officialiseriez	officialiser	Ver:CPre+PL+P2
officialiserions	officialiser	Ver:CPre+PL+P1
officialiser	officialiser	Ver:Inf
officialiserons	officialiser	Ver:IFut+PL+P1
officialiseront	officialiser	Ver:IFut+PL+P3
officialises	officialiser	Ver:IPre+SG+P2
officialisés	officialiser	Ver:PPas+Mas+PL
officialises	officialiser	Ver:SPre+SG+P2
officialisez	officialiser	Ver:IPre+PL+P2:ImPre+PL+P2
officialisiez	officialiser	Ver:IImp+PL+P2:SPre+PL+P2
officialisions	officialiser	Ver:IImp+PL+P1:SPre+PL+P1
officialisons	officialiser	Ver:IPre+PL+P1:ImPre+PL+P1
officialité	officialité	Nom:Fem+SG
official	official	Nom:Mas+SG
officiant	officiant	Adj:Mas+SG
officiant	officiant	Nom:Mas+SG
officiant	officier	Ver:PPre
officiants	officiant	Adj:Mas+PL
officiants	officiant	Nom:Mas+PL
officiaux	official	Nom:Mas+PL
officiellement	officiellement	Adv
officielle	officiel	Adj:Fem+SG
officielle	officiel	Nom:Fem+SG
officielles	officiel	Adj:Fem+PL
officielles	officiel	Nom:Fem+PL
officiel	officiel	Adj:Mas+SG
officiel	officiel	Nom:Mas+SG
officiels	officiel	Adj:Mas+PL
officie	officier	Ver:Imp+SG+P2
officie	officier	Ver:IPre+SG+P1
officie	officier	Ver:IPre+SG+P3
officié	officier	Ver:PPas+Mas+SG
officie	officier	Ver:SPre+SG+P1
officie	officier	Ver:SPre+SG+P3
officière	officier	Nom:Fem+SG
officier	officier	Nom:Mas+SG
officier	officier	Ver:Inf
officiers	officier	Nom:Mas+PL
officieusement	officieusement	Adv
officieuse	officieux	Adj:Fem+SG
officieuses	officieux	Adj:Fem+PL
officieux	officieux	Adj:Mas+InvPL
officinale	officinal	Adj:Fem+SG
officinales	officinal	Adj:Fem+PL
officinal	officinal	Adj:Mas+SG
officinaux	officinal	Adj:Mas+PL
officine	officine	Nom:Fem+SG
officines	officine	Nom:Fem+PL
off	off	Adj:InvGen+SG:InvGen+PL
off	off	Nom:InvGen+SG
offraient	offrir	Ver:IImp+PL+P3
offrais	offrir	Ver:IImp+SG+P1:IImp+SG+P2
offrait	offrir	Ver:IImp+SG+P3
offrande	offrande	Nom:Fem+SG
offrandes	offrande	Nom:Fem+PL
offrant	offrant	Adj:Mas+SG
offrant	offrant	Nom:Mas+SG
offrant	offrir	Ver:PPre
offrants	offrant	Adj:Mas+PL
offrent	offrir	Ver:IPre+PL+P3:SPre+PL+P3
offre	offre	Nom:Fem+SG
offre	offrir	Ver:IPre+SG+P1:IPre+SG+P3:SPre+SG+P1:SPre+SG+P3:ImPre+SG+P2
offres	offre	Nom:Fem+PL
offres	offres	Nom:Fem+PL
offres	offrir	Ver:IPre+SG+P2:SPre+SG+P2
offreur	offreur	Adj:Mas+SG
offreurs	offreur	Adj:Mas+PL
offrez	offrir	Ver:IPre+PL+P2:ImPre+PL+P2
offriez	offrir	Ver:IImp+PL+P2:SPre+PL+P2
offrîmes	offrir	Ver:IPSim+PL+P1
offrions	offrir	Ver:IImp+PL+P1:SPre+PL+P1
offriraient	offrir	Ver:CPre+PL+P3
offrirai	offrir	Ver:IFut+SG+P1
offrirais	offrir	Ver:CPre+SG+P1:CPre+SG+P2
offrirait	offrir	Ver:CPre+SG+P3
offrira	offrir	Ver:IFut+SG+P3
offriras	offrir	Ver:IFut+SG+P2
offrirent	offrir	Ver:IPSim+PL+P3
offrirez	offrir	Ver:IFut+PL+P2
offririez	offrir	Ver:CPre+PL+P2
offririons	offrir	Ver:CPre+PL+P1
offrir	offrir	Ver:Inf
offrirons	offrir	Ver:IFut+PL+P1
offriront	offrir	Ver:IFut+PL+P3
offris	offrir	Ver:IPSim+SG+P1:IPSim+SG+P2
offrissent	offrir	Ver:SImp+PL+P3
offrisse	offrir	Ver:SImp+SG+P1
offrisses	offrir	Ver:SImp+SG+P2
offrissiez	offrir	Ver:SImp+PL+P2
offrissions	offrir	Ver:SImp+PL+P1
offrîtes	offrir	Ver:IPSim+PL+P2
offrit	offrir	Ver:IPSim+SG+P3
offrît	offrir	Ver:SImp+SG+P3
offrons	offrir	Ver:IPre+PL+P1:ImPre+PL+P1
offset	offset	Adj:InvGen+SG:InvGen+PL
offset	offset	Nom:Fem+InvPL
offset	offset	Nom:Mas+InvPL
offsettiste	offsettiste	Nom:InvGen+SG
offshore	offshore	Adj:InvGen+SG:InvGen+PL
offshore	offshore	Nom:Mas+InvPL
offusquaient	offusquer	Ver:IImp+PL+P3
offusquai	offusquer	Ver:IPSim+SG+P1
offusquais	offusquer	Ver:IImp+SG+P1:IImp+SG+P2
offusquait	offusquer	Ver:IImp+SG+P3
offusquâmes	offusquer	Ver:IPSim+PL+P1
offusquant	offusquer	Ver:PPre
offusqua	offusquer	Ver:IPSim+SG+P3
offusquas	offusquer	Ver:IPSim+SG+P2
offusquassent	offusquer	Ver:SImp+PL+P3
offusquasse	offusquer	Ver:SImp+SG+P1
offusquasses	offusquer	Ver:SImp+SG+P2
offusquassiez	offusquer	Ver:SImp+PL+P2
offusquassions	offusquer	Ver:SImp+PL+P1
offusquâtes	offusquer	Ver:IPSim+PL+P2
offusquât	offusquer	Ver:SImp+SG+P3
offusquée	offusquer	Ver:PPas+Fem+SG
offusquées	offusquer	Ver:PPas+Fem+PL
offusquent	offusquer	Ver:IPre+PL+P3:SPre+PL+P3
offusque	offusquer	Ver:IPre+SG+P1:IPre+SG+P3:SPre+SG+P1:SPre+SG+P3:ImPre+SG+P2
offusqué	offusquer	Ver:PPas+Mas+SG
offusqueraient	offusquer	Ver:CPre+PL+P3
offusquerai	offusquer	Ver:IFut+SG+P1
offusquerais	offusquer	Ver:CPre+SG+P1:CPre+SG+P2
offusquerait	offusquer	Ver:CPre+SG+P3
offusquera	offusquer	Ver:IFut+SG+P3
offusqueras	offusquer	Ver:IFut+SG+P2
offusquèrent	offusquer	Ver:IPSim+PL+P3
offusquerez	offusquer	Ver:IFut+PL+P2
offusqueriez	offusquer	Ver:CPre+PL+P2
offusquerions	offusquer	Ver:CPre+PL+P1
offusquer	offusquer	Ver:Inf
offusquerons	offusquer	Ver:IFut+PL+P1
offusqueront	offusquer	Ver:IFut+PL+P3
offusques	offusquer	Ver:IPre+SG+P2:SPre+SG+P2
offusqués	offusquer	Ver:PPas+Mas+PL
offusquez	offusquer	Ver:IPre+PL+P2:ImPre+PL+P2
offusquiez	offusquer	Ver:IImp+PL+P2
offusquiez	offusquer	Ver:SPre+PL+P2
offusquions	offusquer	Ver:IImp+PL+P1:SPre+PL+P1
offusquons	offusquer	Ver:IPre+PL+P1:ImPre+PL+P1
oflag	oflag	Nom:Mas+SG
oghamique	oghamique	Adj:InvGen+SG
ogham	ogham	Adj:InvGen+SG:InvGen+PL
ogham	ogham	Nom:Mas+SG
ogivale	ogival	Adj:Fem+SG
ogivales	ogival	Adj:Fem+PL
ogival	ogival	Adj:Mas+SG
ogivaux	ogival	Adj:Mas+PL
ogive	ogive	Nom:Fem+SG
ogives	ogive	Nom:Fem+PL
ogre	ogre	Nom:Mas+SG
ogres	ogre	Nom:Mas+PL
ogresse	ogre	Nom:Fem+SG
ogresses	ogre	Nom:Fem+PL
ohé	ohé	Int
ohmique	ohmique	Adj:InvGen+SG
ohmmètre	ohmmètre	Nom:Mas+SG
ohm	ohm	Nom:Mas+SG
ohms	ohm	Nom:Mas+PL
oh	oh	Int
oïdie	oïdie	Nom:Fem+SG
oïdium	oïdium	Nom:Mas+SG
oie	oie	Nom:Fem+SG
oie	ouïr	Ver:SPre+SG+P1:SPre+SG+P3
oies	oie	Nom:Fem+PL
oies	ouïr	Ver:SPre+SG+P2
oignaient	oindre	Ver:IImp+PL+P3
oignent	oindre	Ver:IPre+PL+P3:SPre+PL+P3
oignes	oindre	Ver:SPre+SG+P2
oigniez	oindre	Ver:IImp+PL+P2:SPre+PL+P2
oignîmes	oindre	Ver:IPSim+PL+P1
oignions	oindre	Ver:IImp+PL+P1:SPre+PL+P1
oignirent	oindre	Ver:IPSim+PL+P3
oignis	oindre	Ver:IPSim+SG+P1:IPSim+SG+P2
oignisses	oindre	Ver:SImp+SG+P2
oignissiez	oindre	Ver:SImp+PL+P2
oignissions	oindre	Ver:SImp+PL+P1
oignîtes	oindre	Ver:IPSim+PL+P2
oignit	oindre	Ver:IPSim+SG+P3
oignonade	oignonade	Nom:Fem+SG
oignonière	oignonière	Nom:Fem+SG
oignon	oignon	Nom:Mas+SG
oignons	oignon	Nom:Mas+PL
oignons	oindre	Ver:IPre+PL+P1:ImPre+PL+P1
oille	oille	Nom:Fem+SG
oilles	oille	Nom:Fem+PL
oïl	oïl	Nom:Fem+SG
oindraient	oindre	Ver:CPre+PL+P3
oindre	oindre	Ver:Inf
oindrions	oindre	Ver:CPre+PL+P1
oing	oing	Nom:Mas+SG
oins	oindre	Ver:IPre+SG+P1:IPre+SG+P2:ImPre+SG+P2
oint	oindre	Ver:PPas+Mas+SG:IPre+SG+P3
oint	oint	Adj:Mas+SG
oint	oint	Nom:Mas+SG
oiseau	oiseau	Nom:Fem+SG
oiseau	oiseau	Nom:Mas+SG
oiseaux	oiseau	Nom:Mas+PL
oiseaux-lyres	oiseau-lyre	Nom:Mas+PL
oiseaux-mouches	oiseau-mouche	Nom:Mas+PL
oiseau-lyre	oiseau-lyre	Nom:Mas+SG
oiseau-mouche	oiseau-mouche	Nom:Mas+SG
oiselant	oiseler	Ver:PPre
oiselé	oiseler	Ver:PPas+Mas+SG
oiseler	oiseler	Ver:Inf
oiselet	oiselet	Nom:Mas+SG
oiselets	oiselet	Nom:Mas+PL
oiseleur	oiseleur	Nom:Mas+SG
oiseleurs	oiseleur	Nom:Mas+PL
oiselière	oiselier	Nom:Fem+SG
oiselières	oiselier	Nom:Fem+PL
oiselier	oiselier	Nom:Mas+SG
oiseliers	oiselier	Nom:Mas+PL
oisellent	oiseler	Ver:IPre+PL+P3:SPre+PL+P3
oiselle	oiseler	Ver:IPre+SG+P1:IPre+SG+P3:SPre+SG+P1:SPre+SG+P3:ImPre+SG+P2
oiselle	oiselle	Nom:Fem+SG
oiselleraient	oiseler	Ver:CPre+PL+P3
oisellerai	oiseler	Ver:IFut+SG+P1
oisellerais	oiseler	Ver:CPre+SG+P1:CPre+SG+P2
oisellerait	oiseler	Ver:CPre+SG+P3
oisellera	oiseler	Ver:IFut+SG+P3
oiselleras	oiseler	Ver:IFut+SG+P2
oisellerez	oiseler	Ver:IFut+PL+P2
oisellerie	oisellerie	Nom:Fem+SG
oiselleries	oisellerie	Nom:Fem+PL
oiselleriez	oiseler	Ver:CPre+PL+P2
oisellerions	oiseler	Ver:CPre+PL+P1
oisellerons	oiseler	Ver:IFut+PL+P1
oiselleront	oiseler	Ver:IFut+PL+P3
oiselles	oiseler	Ver:IPre+SG+P2:SPre+SG+P2
oiselles	oiselle	Nom:Fem+PL
oiseusement	oiseusement	Adv
oiseuse	oiseux	Adj:Fem+SG
oiseuses	oiseux	Adj:Fem+PL
oiseux	oiseux	Adj:Mas+InvPL
oisif	oisif	Adj:Mas+SG
oisif	oisif	Nom:Mas+SG
oisifs	oisif	Adj:Mas+PL
oisifs	oisif	Nom:Mas+PL
oisillon	oisillon	Nom:Mas+SG
oisillons	oisillon	Nom:Mas+PL
oisivement	oisivement	Adv
oisive	oisif	Adj:Fem+SG
oisive	oisif	Nom:Fem+SG
oisives	oisif	Adj:Fem+PL
oisives	oisif	Nom:Fem+PL
oisiveté	oisiveté	Nom:Fem+SG
oison	oison	Nom:Mas+SG
oisons	oison	Nom:Mas+PL
ois	ouïr	Ver:IPre+SG+P1:IPre+SG+P2:ImPre+SG+P2
oit	ouïr	Ver:IPre+SG+P3
okapi	okapi	Nom:Mas+SG
okapis	okapi	Nom:Mas+PL
okoumé	okoumé	Nom:Mas+SG
okoumés	okoumé	Nom:Mas+PL
oléacée	oléacé	Adj:Fem+SG
oléacée	oléacée	Nom:Fem+SG
oléacées	oléacé	Adj:Fem+PL
oléacées	oléacée	Nom:Fem+PL
oléagineuse	oléagineux	Adj:Fem+SG
oléagineuses	oléagineux	Adj:Fem+PL
oléagineux	oléagineux	Adj:Mas+InvPL
oléagineux	oléagineux	Nom:Mas+InvPL
oléandomycine	oléandomycine	Nom:Fem+SG
oléastre	oléastre	Nom:Mas+SG
oléate	oléate	Nom:Mas+SG
oléfiante	oléfiant	Adj:Fem+SG
oléfiantes	oléfiant	Adj:Fem+PL
oléfiant	oléfiant	Adj:Mas+SG
oléfine	oléfine	Nom:Fem+SG
oléfines	oléfine	Nom:Fem+PL
oléicole	oléicole	Adj:InvGen+SG
oléicoles	oléicole	Adj:InvGen+PL
oléiculteur	oléiculteur	Nom:Mas+SG
oléiculteurs	oléiculteur	Nom:Mas+PL
oléicultrice	oléiculteur	Nom:Fem+SG
oléicultrices	oléiculteur	Nom:Fem+PL
oléiculture	oléiculture	Nom:Fem+SG
oléifère	oléifère	Adj:InvGen+SG
oléifiant	oléifiant	Adj:Mas+SG
oléiforme	oléiforme	Adj:InvGen+SG
oléine	oléine	Nom:Fem+SG
oléique	oléique	Adj:InvGen+SG
oléoduc	oléoduc	Nom:Mas+SG
oléoducs	oléoduc	Nom:Mas+PL
oléolat	oléolat	Nom:Mas+SG
olé	olé	Int
oléomètre	oléomètre	Nom:Mas+SG
oléorésine	oléorésine	Nom:Fem+SG
oléum	oléum	Nom:Mas+SG
olfactif	olfactif	Adj:Mas+SG
olfactifs	olfactif	Adj:Mas+PL
olfaction	olfaction	Nom:Fem+SG
olfactive	olfactif	Adj:Fem+SG
olfactives	olfactif	Adj:Fem+PL
oliban	oliban	Nom:Mas+SG
olibrius	olibrius	Nom:Mas+InvPL
olifant	olifant	Nom:Mas+SG
olifants	olifant	Nom:Mas+PL
oligarchie	oligarchie	Nom:Fem+SG
oligarchies	oligarchie	Nom:Fem+PL
oligarchique	oligarchique	Adj:InvGen+SG
oligarchiques	oligarchique	Adj:InvGen+PL
oligarque	oligarque	Nom:InvGen+SG
oligiste	oligiste	Adj:InvGen+SG
oligiste	oligiste	Nom:Mas+SG
oligocène	oligocène	Adj:InvGen+SG
oligochète	oligochète	Adj:InvGen+SG
oligochètes	oligochète	Adj:InvGen+PL
oligochètes	oligochète	Nom:Mas+PL
oligoclase	oligoclase	Nom:Fem+SG
oligodendroglie	oligodendroglie	Nom:Fem+SG
oligophrène	oligophrène	Adj:InvGen+SG
oligophrène	oligophrène	Nom:InvGen+SG
oligophrénie	oligophrénie	Nom:Fem+SG
oligopole	oligopole	Nom:Mas+SG
oligopolistique	oligopolistique	Adj:InvGen+SG
oligopsone	oligopsone	Nom:Mas+SG
oligo-élément	oligo-élément	Nom:Mas+SG
oligurie	oligurie	Nom:Fem+SG
olim	olim	Nom:Mas+InvPL
oliphant	oliphant	Nom:Mas+SG
olivacée	olivacé	Adj:Fem+SG
olivacées	olivacé	Adj:Fem+PL
olivacé	olivacé	Adj:Mas+SG
olivaie	olivaie	Nom:Fem+SG
olivaies	olivaie	Nom:Fem+PL
olivaison	olivaison	Nom:Fem+SG
olivâtre	olivâtre	Adj:InvGen+SG
olivâtres	olivâtre	Adj:InvGen+PL
olive	olive	Adj:InvGen+SG:InvGen+PL
olive	olive	Nom:Fem+SG
olive	oliver	Ver:IPre+SG+P1:IPre+SG+P3:SPre+SG+P1:SPre+SG+P3:ImPre+SG+P2
oliveraie	oliveraie	Nom:Fem+SG
oliveraies	oliveraie	Nom:Fem+PL
olives	olive	Nom:Fem+PL
olives	oliver	Ver:IPre+SG+P2:SPre+SG+P2
olives	olives	Nom:Fem+PL
olivétain	olivétain	Nom:Mas+SG
olivet	olivet	Nom:Mas+SG
olivette	olivette	Nom:Fem+SG
olivettes	olivette	Nom:Fem+PL
olivier	olivier	Nom:Mas+SG
oliviers	olivier	Nom:Mas+PL
olivine	olivine	Nom:Fem+SG
olivines	olivine	Nom:Fem+PL
ollaire	ollaire	Adj:InvGen+SG
ollé	ollé	Int
olographe	olographe	Adj:InvGen+SG
olympe	olympe	Nom:Mas+SG
olympes	olympe	Nom:Mas+PL
olympiade	olympiade	Nom:Fem+SG
olympiades	olympiade	Nom:Fem+PL
olympienne	olympien	Adj:Fem+SG
olympiennes	olympien	Adj:Fem+PL
olympien	olympien	Adj:Mas+SG
olympiens	olympien	Adj:Mas+PL
olympique	olympique	Adj:InvGen+SG
olympiques	olympique	Adj:InvGen+PL
olympisme	olympisme	Nom:Mas+SG
ombellale	ombellale	Nom:Fem+SG
ombellée	ombellé	Adj:Fem+SG
ombelle	ombelle	Nom:Fem+SG
ombelliféracées	ombelliféracée	Nom:Fem+PL
ombellifère	ombellifère	Adj:InvGen+SG
ombellifère	ombellifère	Nom:Fem+SG
ombellifères	ombellifère	Nom:Fem+PL
ombelliforme	ombelliforme	Adj:InvGen+SG
ombellule	ombellule	Nom:Fem+SG
ombilicale	ombilical	Adj:Fem+SG
ombilicale	ombilicale	Nom:Fem+SG
ombilicales	ombilical	Adj:Fem+PL
ombilicales	ombilicale	Nom:Fem+PL
ombilical	ombilical	Adj:Mas+SG
ombilicaux	ombilical	Adj:Mas+PL
ombilic	ombilic	Nom:Mas+SG
ombilics	ombilic	Nom:Mas+PL
ombiliquée	ombiliqué	Adj:Fem+SG
ombiliquée	ombiliquer	Ver:PPas+Fem+SG
ombiliquées	ombiliqué	Adj:Fem+PL
ombiliquées	ombiliquer	Ver:PPas+Fem+PL
ombiliqué	ombiliqué	Adj:Mas+SG
ombiliqué	ombiliquer	Ver:PPas+Mas+SG
omble	omble	Nom:Mas+SG
ombrageaient	ombrager	Ver:IImp+PL+P3
ombrageait	ombrager	Ver:IImp+SG+P3
ombrageant	ombrager	Ver:PPre
ombragée	ombragé	Adj:Fem+SG
ombragées	ombragé	Adj:Fem+PL
ombragent	ombrager	Ver:IPre+PL+P3:SPre+PL+P3
ombragé	ombragé	Adj:Mas+SG
ombrage	ombrage	Nom:Mas+SG
ombrage	ombrager	Ver:IPre+SG+P1:IPre+SG+P3:SPre+SG+P1:SPre+SG+P3:ImPre+SG+P2
ombrager	ombrager	Ver:Inf
ombragés	ombragé	Adj:Mas+PL
ombrages	ombrage	Nom:Mas+PL
ombrages	ombrager	Ver:IPre+SG+P2:SPre+SG+P2
ombragés	ombrager	Ver:PPas+Mas+PL
ombrageuse	ombrageux	Adj:Fem+SG
ombrageuses	ombrageux	Adj:Fem+PL
ombrageux	ombrageux	Adj:Mas+InvPL
ombraient	ombrer	Ver:IImp+PL+P3
ombrai	ombrer	Ver:IPSim+SG+P1
ombrais	ombrer	Ver:IImp+SG+P1:IImp+SG+P2
ombrait	ombrer	Ver:IImp+SG+P3
ombrâmes	ombrer	Ver:IPSim+PL+P1
ombrante	ombrer	Ver:PPre+Fem+SG
ombrant	ombrer	Ver:PPre
ombra	ombrer	Ver:IPSim+SG+P3
ombras	ombrer	Ver:IPSim+SG+P2
ombrassent	ombrer	Ver:SImp+PL+P3
ombrasse	ombrer	Ver:SImp+SG+P1
ombrasses	ombrer	Ver:SImp+SG+P2
ombrassiez	ombrer	Ver:SImp+PL+P2
ombrassions	ombrer	Ver:SImp+PL+P1
ombrâtes	ombrer	Ver:IPSim+PL+P2
ombrât	ombrer	Ver:SImp+SG+P3
ombrée	ombrée	Nom:Fem+SG
ombrée	ombrer	Ver:PPas+Fem+SG
ombrées	ombrée	Nom:Fem+PL
ombrées	ombrer	Ver:PPas+Fem+PL
ombrelle	ombrelle	Nom:Fem+SG
ombrelles	ombrelle	Nom:Fem+PL
ombrent	ombrer	Ver:IPre+PL+P3:SPre+PL+P3
ombre	ombre	Nom:Fem+SG
ombre	ombre	Nom:Mas+SG
ombre	ombrer	Ver:IPre+SG+P1:IPre+SG+P3:SPre+SG+P1:SPre+SG+P3:ImPre+SG+P2
ombré	ombrer	Ver:PPas+Mas+SG
ombreraient	ombrer	Ver:CPre+PL+P3
ombrerai	ombrer	Ver:IFut+SG+P1
ombrerais	ombrer	Ver:CPre+SG+P1:CPre+SG+P2
ombrerait	ombrer	Ver:CPre+SG+P3
ombrera	ombrer	Ver:IFut+SG+P3
ombreras	ombrer	Ver:IFut+SG+P2
ombrèrent	ombrer	Ver:IPSim+PL+P3
ombrerez	ombrer	Ver:IFut+PL+P2
ombreriez	ombrer	Ver:CPre+PL+P2
ombrerions	ombrer	Ver:CPre+PL+P1
ombrer	ombrer	Ver:Inf
ombrerons	ombrer	Ver:IFut+PL+P1
ombreront	ombrer	Ver:IFut+PL+P3
ombres	ombre	Nom:Fem+PL
ombres	ombre	Nom:Mas+PL
ombres	ombrer	Ver:IPre+SG+P2:SPre+SG+P2
ombrés	ombrer	Ver:PPas+Mas+PL
ombrette	ombrette	Nom:Fem+SG
ombreuse	ombreux	Adj:Fem+SG
ombreuses	ombreux	Adj:Fem+PL
ombreux	ombreux	Adj:Mas+InvPL
ombrez	ombrer	Ver:IPre+PL+P2:ImPre+PL+P2
ombrienne	ombrien	Adj:Fem+SG
ombrienne	ombrien	Nom:Fem+SG
ombriennes	ombrien	Adj:Fem+PL
ombriennes	ombrien	Nom:Fem+PL
ombrien	ombrien	Adj:Mas+SG
ombrien	ombrien	Nom:Mas+SG
ombriens	ombrien	Adj:Mas+PL
ombriens	ombrien	Nom:Mas+PL
ombriez	ombrer	Ver:IImp+PL+P2:SPre+PL+P2
ombrine	ombrine	Nom:Fem+SG
ombrions	ombrer	Ver:IImp+PL+P1:SPre+PL+P1
ombrons	ombrer	Ver:IPre+PL+P1:ImPre+PL+P1
ombudsman	ombudsman	Nom:Mas+SG
oméga	oméga	Nom:Mas+InvPL
omelette	omelette	Nom:Fem+SG
omelettes	omelette	Nom:Fem+PL
omet	omettre	Ver:IPre+SG+P3
omets	omettre	Ver:IPre+SG+P1:IPre+SG+P2:ImPre+SG+P2
omettaient	omettre	Ver:IImp+PL+P3
omettais	omettre	Ver:IImp+SG+P1:IImp+SG+P2
omettait	omettre	Ver:IImp+SG+P3
omettant	omettre	Ver:PPre
omettent	omettre	Ver:IPre+PL+P3:SPre+PL+P3
omette	omettre	Ver:SPre+SG+P1:SPre+SG+P3
omettes	omettre	Ver:SPre+SG+P2
omettez	omettre	Ver:IPre+PL+P2:ImPre+PL+P2
omettiez	omettre	Ver:IImp+PL+P2:SPre+PL+P2
omettions	omettre	Ver:IImp+PL+P1:SPre+PL+P1
omettons	omettre	Ver:IPre+PL+P1:ImPre+PL+P1
omettraient	omettre	Ver:CPre+PL+P3
omettrai	omettre	Ver:IFut+SG+P1
omettrais	omettre	Ver:CPre+SG+P1:CPre+SG+P2
omettrait	omettre	Ver:CPre+SG+P3
omettra	omettre	Ver:IFut+SG+P3
omettras	omettre	Ver:IFut+SG+P2
omettre	omettre	Ver:Inf
omettrez	omettre	Ver:IFut+PL+P2
omettriez	omettre	Ver:CPre+PL+P2
omettrions	omettre	Ver:CPre+PL+P1
omettrons	omettre	Ver:IFut+PL+P1
omettront	omettre	Ver:IFut+PL+P3
omicron	omicron	Nom:Mas+InvPL
omîmes	omettre	Ver:IPSim+PL+P1
omirent	omettre	Ver:IPSim+PL+P3
omise	omettre	Ver:PPas+Fem+SG
omises	omettre	Ver:PPas+Fem+PL
omis	omettre	Ver:PPas+Mas+SG:PPas+Mas+PL:IPSim+SG+P1:IPSim+SG+P2
omis	omettre	Ver:PPas+Mas+SG:IPSim+SG+P1:IPSim+SG+P2
omis	omis	Nom:Mas+InvPL
omissent	omettre	Ver:SImp+PL+P3
omisse	omettre	Ver:SImp+SG+P1
omisses	omettre	Ver:SImp+SG+P2
omissiez	omettre	Ver:SImp+PL+P2
omission	omission	Nom:Fem+SG
omissions	omettre	Ver:SImp+PL+P1
omissions	omission	Nom:Fem+PL
omîtes	omettre	Ver:IPSim+PL+P2
omit	omettre	Ver:IPSim+SG+P3
omît	omettre	Ver:SImp+SG+P3
ommatidie	ommatidie	Nom:Fem+SG
omnibus	omnibus	Adj:InvGen+SG:InvGen+PL
omnibus	omnibus	Nom:Mas+InvPL
omnicolore	omnicolore	Adj:InvGen+SG
omnidirectionnelle	omnidirectionnel	Adj:Fem+SG
omnidirectionnelles	omnidirectionnel	Adj:Fem+PL
omnidirectionnel	omnidirectionnel	Adj:Mas+SG
omnipotence	omnipotence	Nom:Fem+SG
omnipotente	omnipotent	Adj:Fem+SG
omnipotentes	omnipotent	Adj:Fem+PL
omnipotent	omnipotent	Adj:Mas+SG
omnipotents	omnipotent	Adj:Mas+PL
omnipraticienne	omnipraticien	Adj:Fem+SG
omnipraticienne	omnipraticien	Nom:Fem+SG
omnipraticiennes	omnipraticien	Adj:Fem+PL
omnipraticiennes	omnipraticien	Nom:Fem+PL
omnipraticien	omnipraticien	Adj:Mas+SG
omnipraticien	omnipraticien	Nom:Mas+SG
omnipraticiens	omnipraticien	Adj:Mas+PL
omnipraticiens	omnipraticien	Nom:Mas+PL
omniprésence	omniprésence	Nom:Fem+SG
omniprésente	omniprésent	Adj:Fem+SG
omniprésentes	omniprésent	Adj:Fem+PL
omniprésent	omniprésent	Adj:Mas+SG
omniprésents	omniprésent	Adj:Mas+PL
omniscience	omniscience	Nom:Fem+SG
omnisciente	omniscient	Adj:Fem+SG
omniscientes	omniscient	Adj:Fem+PL
omniscient	omniscient	Adj:Mas+SG
omniscients	omniscient	Adj:Mas+PL
omnisports	omnisports	Adj:InvGen+SG:InvGen+PL
omnium	omnium	Nom:Mas+SG
omniums	omnium	Nom:Mas+PL
omnivore	omnivore	Adj:InvGen+SG
omoplate	omoplate	Nom:Fem+SG
omoplates	omoplate	Nom:Fem+PL
onagracée	onagracée	Nom:Fem+SG
onagracées	onagracée	Nom:Fem+PL
onagrariacées	onagrariacée	Nom:Fem+PL
onagrariées	onagrariée	Nom:Fem+PL
onagre	onagre	Nom:Fem+SG
onagre	onagre	Nom:Mas+SG
onagres	onagre	Nom:Fem+PL
onagres	onagre	Nom:Mas+PL
onanisme	onanisme	Nom:Mas+SG
onaniste	onaniste	Adj:InvGen+SG
onaniste	onaniste	Nom:Mas+SG
once	once	Nom:Fem+SG
onces	once	Nom:Fem+PL
onchocercose	onchocercose	Nom:Fem+SG
onciale	oncial	Adj:Fem+SG
onciale	onciale	Nom:Fem+SG
onciales	oncial	Adj:Fem+PL
onciales	onciale	Nom:Fem+PL
oncial	oncial	Adj:Mas+SG
onciaux	oncial	Adj:Mas+PL
oncle	oncle	Nom:Mas+SG
oncles	oncle	Nom:Mas+PL
oncogène	oncogène	Adj:InvGen+SG
oncologie	oncologie	Nom:Fem+SG
onc	onc	Adv
oncotique	oncotique	Adj:InvGen+SG
oncques	oncques	Adv
onction	onction	Nom:Fem+SG
onctions	onction	Nom:Fem+PL
onctueusement	onctueusement	Adv
onctueuse	onctueux	Adj:Fem+SG
onctueuses	onctueux	Adj:Fem+PL
onctueux	onctueux	Adj:Mas+InvPL
onctuosité	onctuosité	Nom:Fem+SG
ondatra	ondatra	Nom:Mas+SG
ondée	ondé	Adj:Fem+SG
ondée	ondée	Nom:Fem+SG
ondée	onder	Ver:PPas+Fem+SG
ondées	ondé	Adj:Fem+PL
ondées	ondée	Nom:Fem+PL
ondées	onder	Ver:PPas+Fem+PL
ondemètre	ondemètre	Nom:Mas+SG
ondé	ondé	Adj:Mas+SG
onde	onde	Nom:Fem+SG
onde	onder	Ver:IPre+SG+P1:IPre+SG+P3:SPre+SG+P1:SPre+SG+P3:ImPre+SG+P2
ondé	onder	Ver:PPas+Mas+SG
ondés	ondé	Adj:Mas+PL
ondes	onde	Nom:Fem+PL
ondes	onder	Ver:IPre+SG+P2:SPre+SG+P2
ondés	onder	Ver:PPas+Mas+PL
ondes	ondes	Nom:Fem+PL
ondine	ondin	Nom:Fem+SG
ondines	ondin	Nom:Fem+PL
ondin	ondin	Nom:Mas+SG
ondins	ondin	Nom:Mas+PL
ondoiement	ondoiement	Nom:Mas+SG
ondoyait	ondoyer	Ver:IImp+SG+P3
ondoyante	ondoyant	Adj:Fem+SG
ondoyantes	ondoyant	Adj:Fem+PL
ondoyant	ondoyant	Adj:Mas+SG
ondoyant	ondoyer	Ver:PPre
ondoyants	ondoyant	Adj:Mas+PL
ondoyé	ondoyer	Ver:PPas+Mas+SG
ondoyer	ondoyer	Ver:Inf
ondulaient	onduler	Ver:IImp+PL+P3
ondulai	onduler	Ver:IPSim+SG+P1
ondulais	onduler	Ver:IImp+SG+P1:IImp+SG+P2
ondulait	onduler	Ver:IImp+SG+P3
ondulâmes	onduler	Ver:IPSim+PL+P1
ondulante	ondulant	Adj:Fem+SG
ondulantes	ondulant	Adj:Fem+PL
ondulant	ondulant	Adj:Mas+SG
ondulants	ondulant	Adj:Mas+PL
ondula	onduler	Ver:IPSim+SG+P3
ondulas	onduler	Ver:IPSim+SG+P2
ondulassent	onduler	Ver:SImp+PL+P3
ondulasse	onduler	Ver:SImp+SG+P1
ondulasses	onduler	Ver:SImp+SG+P2
ondulassiez	onduler	Ver:SImp+PL+P2
ondulassions	onduler	Ver:SImp+PL+P1
ondulâtes	onduler	Ver:IPSim+PL+P2
ondulation	ondulation	Nom:Fem+SG
ondulations	ondulation	Nom:Fem+PL
ondulatoire	ondulatoire	Adj:InvGen+SG
ondulatoires	ondulatoire	Adj:InvGen+PL
ondulât	onduler	Ver:SImp+SG+P3
ondulée	ondulé	Adj:Fem+SG
ondulée	onduler	Ver:PPas+Fem+SG
ondulées	ondulé	Adj:Fem+PL
ondulées	onduler	Ver:PPas+Fem+PL
ondulent	onduler	Ver:IPre+PL+P3:SPre+PL+P3
ondulé	ondulé	Adj:Mas+SG
ondule	onduler	Ver:IPre+SG+P1:IPre+SG+P3:SPre+SG+P1:SPre+SG+P3:ImPre+SG+P2
onduleraient	onduler	Ver:CPre+PL+P3
ondulerai	onduler	Ver:IFut+SG+P1
ondulerais	onduler	Ver:CPre+SG+P1:CPre+SG+P2
ondulerait	onduler	Ver:CPre+SG+P3
ondulera	onduler	Ver:IFut+SG+P3
onduleras	onduler	Ver:IFut+SG+P2
ondulèrent	onduler	Ver:IPSim+PL+P3
ondulerez	onduler	Ver:IFut+PL+P2
onduleriez	onduler	Ver:CPre+PL+P2
ondulerions	onduler	Ver:CPre+PL+P1
onduler	onduler	Ver:Inf
ondulerons	onduler	Ver:IFut+PL+P1
onduleront	onduler	Ver:IFut+PL+P3
ondulés	ondulé	Adj:Mas+PL
ondules	onduler	Ver:IPre+SG+P2:SPre+SG+P2
onduleur	onduleur	Nom:Mas+SG
onduleuse	onduleuse	Nom:Fem+SG
onduleuse	onduleux	Adj:Fem+SG
onduleuses	onduleuse	Nom:Fem+PL
onduleuses	onduleux	Adj:Fem+PL
onduleux	onduleux	Adj:Mas+InvPL
ondulez	onduler	Ver:IPre+PL+P2:ImPre+PL+P2
onduliez	onduler	Ver:IImp+PL+P2:SPre+PL+P2
ondulions	onduler	Ver:IImp+PL+P1:SPre+PL+P1
ondulons	onduler	Ver:IPre+PL+P1:ImPre+PL+P1
onéreusement	onéreusement	Adv
onéreuse	onéreux	Adj:Fem+SG
onéreuses	onéreux	Adj:Fem+PL
onéreux	onéreux	Adj:Mas+InvPL
one-man-show	one-man-show	Nom:Mas+SG
one-step	one-step	Nom:Mas+InvPL
one-step	one-step	Nom:Mas+SG
onglée	onglé	Adj:Fem+SG
onglée	onglée	Nom:Fem+SG
onglées	onglé	Adj:Fem+PL
onglées	onglée	Nom:Fem+PL
ongle	ongle	Nom:Mas+SG
ongles	ongle	Nom:Mas+PL
onglet	onglet	Nom:Mas+SG
onglets	onglet	Nom:Mas+PL
onglette	onglette	Nom:Fem+SG
onglettes	onglette	Nom:Fem+PL
onglier	onglier	Nom:Mas+SG
ongliers	onglier	Nom:Mas+PL
onglon	onglon	Nom:Mas+SG
onguent	onguent	Nom:Mas+SG
onguents	onguent	Nom:Mas+PL
onguiculée	onguiculé	Adj:Fem+SG
onguiculées	onguiculé	Adj:Fem+PL
onguiculé	onguiculé	Adj:Mas+SG
onguiculé	onguiculé	Nom:Mas+SG
onguiforme	onguiforme	Adj:InvGen+SG
ongulée	ongulé	Adj:Fem+SG
ongulées	ongulé	Adj:Fem+PL
ongulé	ongulé	Adj:Mas+SG
onguligrade	onguligrade	Adj:InvGen+SG
onirique	onirique	Adj:InvGen+SG
oniriques	onirique	Adj:InvGen+PL
onirisme	onirisme	Nom:Mas+SG
onirologie	onirologie	Nom:Fem+SG
onirologue	onirologue	Nom:InvGen+SG
oniromancienne	oniromancien	Adj:Fem+SG
oniromancienne	oniromancien	Nom:Fem+SG
oniromanciennes	oniromancien	Adj:Fem+PL
oniromanciennes	oniromancien	Nom:Fem+PL
oniromancien	oniromancien	Adj:Mas+SG
oniromancien	oniromancien	Nom:Mas+SG
oniromancie	oniromancie	Nom:Fem+SG
onirothérapie	onirothérapie	Nom:Fem+SG
onkotique	onkotique	Adj:InvGen+SG
onomasiologie	onomasiologie	Nom:Fem+SG
onomastique	onomastique	Adj:InvGen+SG
onomastique	onomastique	Nom:Fem+SG
onomatopée	onomatopée	Nom:Fem+SG
onomatopées	onomatopée	Nom:Fem+PL
onomatopéique	onomatopéique	Adj:InvGen+SG
on	on	Pro:3Mas+SG
onques	onques	Adv
ontarien	ontarien	Adj:Mas+SG
ontique	ontique	Adj:InvGen+SG
ontogenèse	ontogenèse	Nom:Fem+SG
ontogénétique	ontogénétique	Adj:InvGen+SG
ontogénie	ontogénie	Nom:Fem+SG
ontogénique	ontogénique	Adj:InvGen+SG
ontologie	ontologie	Nom:Fem+SG
ontologiquement	ontologiquement	Adv
ontologique	ontologique	Adj:InvGen+SG
ontologisme	ontologisme	Nom:Mas+SG
onusien	onusien	Adj:Mas+SG
onychomycose	onychomycose	Nom:Fem+SG
onychophagie	onychophagie	Nom:Fem+SG
onychophore	onychophore	Nom:Mas+SG
onyxis	onyxis	Nom:Mas+InvPL
onyx	onyx	Nom:Mas+InvPL
onzain	onzain	Nom:Mas+SG
onze	onze	Det:InvGen+PL
onze	onze	Nom:Mas+InvPL
onzièmement	onzièmement	Adv
onzième	onzième	Adj:InvGen+SG
onzième	onzième	Nom:Fem+SG
onzième	onzième	Nom:InvGen+SG
onzième	onzième	Nom:Mas+SG
onzièmes	onzième	Adj:InvGen+PL
onzièmes	onzième	Nom:Fem+PL
onzièmes	onzième	Nom:InvGen+PL
onzièmes	onzième	Nom:Mas+PL
on-dit	on-dit	Nom:Mas+InvPL
oocyte	oocyte	Nom:Mas+SG
oogone	oogone	Nom:Fem+SG
ô	ô	Int
oolite	oolite	Nom:InvGen+SG
oolithe	oolithe	Nom:InvGen+SG
oolithique	oolithique	Adj:InvGen+SG
o	o	Nom:Mas+InvPL
oosphère	oosphère	Nom:Fem+SG
oospore	oospore	Nom:Fem+SG
oothèque	oothèque	Nom:Fem+SG
opacifiant	opacifiant	Adj:Mas+SG
opacifiant	opacifiant	Nom:Mas+SG
opacifiant	opacifier	Ver:PPre
opacification	opacification	Nom:Fem+SG
opacifié	opacifier	Ver:PPas+Mas+SG
opacifier	opacifier	Ver:Inf
opacimétrie	opacimétrie	Nom:Fem+SG
opacité	opacité	Nom:Fem+SG
opale	opale	Adj:InvGen+SG:InvGen+PL
opale	opale	Nom:Fem+SG
opalescence	opalescence	Nom:Fem+SG
opalescente	opalescent	Adj:Fem+SG
opalescentes	opalescent	Adj:Fem+PL
opalescent	opalescent	Adj:Mas+SG
opalescents	opalescent	Adj:Mas+PL
opales	opale	Nom:Fem+PL
opaline	opalin	Adj:Fem+SG
opaline	opaline	Nom:Fem+SG
opalines	opalin	Adj:Fem+PL
opalines	opaline	Nom:Fem+PL
opalin	opalin	Adj:Mas+SG
opalins	opalin	Adj:Mas+PL
opalisant	opaliser	Ver:PPre
opalisation	opalisation	Nom:Fem+SG
opalisations	opalisation	Nom:Fem+PL
opalisé	opaliser	Ver:PPas+Mas+SG
opaliser	opaliser	Ver:Inf
opalisés	opaliser	Ver:PPas+Mas+PL
opaquement	opaquement	Adv
opaque	opaque	Adj:InvGen+SG
opaques	opaque	Adj:InvGen+PL
openfield	openfield	Nom:Mas+SG
openfields	openfield	Nom:Mas+PL
open	open	Adj:InvGen+SG:InvGen+PL
open	open	Nom:Mas+SG
ope	ope	Nom:InvGen+SG
opérable	opérable	Adj:InvGen+SG
opérables	opérable	Adj:InvGen+PL
opéraient	opérer	Ver:IImp+PL+P3
opérai	opérer	Ver:IPSim+SG+P1
opérais	opérer	Ver:IImp+SG+P1:IImp+SG+P2
opérait	opérer	Ver:IImp+SG+P3
opérâmes	opérer	Ver:IPSim+PL+P1
opérande	opérande	Nom:Mas+SG
opérandes	opérande	Nom:Mas+PL
opérante	opérant	Adj:Fem+SG
opérantes	opérant	Adj:Fem+PL
opérant	opérant	Adj:Mas+SG
opérant	opérer	Ver:PPre
opérants	opérant	Adj:Mas+PL
opéra	opéra	Nom:Mas+SG
opéra	opérer	Ver:IPSim+SG+P3
opéras	opéra	Nom:Mas+PL
opéras	opérer	Ver:IPSim+SG+P2
opérassent	opérer	Ver:SImp+PL+P3
opérasse	opérer	Ver:SImp+SG+P1
opérasses	opérer	Ver:SImp+SG+P2
opérassiez	opérer	Ver:SImp+PL+P2
opérassions	opérer	Ver:SImp+PL+P1
opéras-comiques	opéra-comique	Nom:Mas+PL
opérâtes	opérer	Ver:IPSim+PL+P2
opérateur	opérateur	Nom:Mas+SG
opérateurs	opérateur	Nom:Mas+PL
opérationnelle	opérationnel	Adj:Fem+SG
opérationnelles	opérationnel	Adj:Fem+PL
opérationnel	opérationnel	Adj:Mas+SG
opérationnels	opérationnel	Adj:Mas+PL
opérationnisme	opérationnisme	Nom:Mas+SG
opérationnismes	opérationnisme	Nom:Mas+PL
opération	opération	Nom:Fem+SG
opérations	opération	Nom:Fem+PL
opératoire	opératoire	Adj:InvGen+SG
opératoires	opératoire	Adj:InvGen+PL
opérât	opérer	Ver:SImp+SG+P3
opératrice	opérateur	Nom:Fem+SG
opératrices	opérateur	Nom:Fem+PL
opéra-comique	opéra-comique	Nom:Mas+SG
operculaire	operculaire	Adj:InvGen+SG
operculaire	operculaire	Nom:Fem+SG
operculaire	operculaire	Nom:Mas+SG
operculaires	operculaire	Adj:InvGen+PL
operculaires	operculaire	Nom:Fem+PL
operculaires	operculaire	Nom:Mas+PL
operculée	operculé	Adj:Fem+SG
operculée	operculer	Ver:PPas+Fem+SG
operculées	operculé	Adj:Fem+PL
operculées	operculer	Ver:PPas+Fem+PL
opercule	opercule	Nom:Mas+SG
opercule	operculer	Ver:IPre+SG+P1:IPre+SG+P3:SPre+SG+P1:SPre+SG+P3:ImPre+SG+P2
opercules	opercule	Nom:Mas+PL
opercules	operculer	Ver:IPre+SG+P2:SPre+SG+P2
opérée	opéré	Adj:Fem+SG
opérée	opéré	Nom:Fem+SG
opérée	opérer	Ver:PPas+Fem+SG
opérées	opéré	Adj:Fem+PL
opérées	opéré	Nom:Fem+PL
opérées	opérer	Ver:PPas+Fem+PL
opèrent	opérer	Ver:IPre+PL+P3:SPre+PL+P3
opéré	opéré	Adj:Mas+SG
opéré	opéré	Nom:Mas+SG
opère	opérer	Ver:IPre+SG+P1:IPre+SG+P3:SPre+SG+P1:SPre+SG+P3:ImPre+SG+P2
opéré	opérer	Ver:PPas+Mas+SG
opéreraient	opérer	Ver:CPre+PL+P3
opérerai	opérer	Ver:IFut+SG+P1
opérerais	opérer	Ver:CPre+SG+P1:CPre+SG+P2
opérerait	opérer	Ver:CPre+SG+P3
opérera	opérer	Ver:IFut+SG+P3
opéreras	opérer	Ver:IFut+SG+P2
opérèrent	opérer	Ver:IPSim+PL+P3
opérerez	opérer	Ver:IFut+PL+P2
opéreriez	opérer	Ver:CPre+PL+P2
opérerions	opérer	Ver:CPre+PL+P1
opérerons	opérer	Ver:IFut+PL+P1
opéreront	opérer	Ver:IFut+PL+P3
opérer	opérer	Ver:Inf
opérés	opéré	Adj:Mas+PL
opérés	opéré	Nom:Mas+PL
opères	opérer	Ver:IPre+SG+P2:SPre+SG+P2
opérés	opérer	Ver:PPas+Mas+PL
opérette	opérette	Nom:Fem+SG
opérettes	opérette	Nom:Fem+PL
opérez	opérer	Ver:IPre+PL+P2:ImPre+PL+P2
opériez	opérer	Ver:IImp+PL+P2:SPre+PL+P2
opérions	opérer	Ver:IImp+PL+P1:SPre+PL+P1
opéron	opéron	Nom:Mas+SG
opérons	opérer	Ver:IPre+PL+P1:ImPre+PL+P1
opérons	opéron	Nom:Mas+PL
opes	ope	Nom:InvGen+PL
ophicléide	ophicléide	Nom:Mas+SG
ophidienne	ophidien	Adj:Fem+SG
ophidien	ophidien	Adj:Mas+SG
ophidiens	ophidien	Adj:Mas+PL
ophidiens	ophidien	Nom:Mas+PL
ophioglosse	ophioglosse	Nom:Mas+SG
ophioglosses	ophioglosse	Nom:Mas+PL
ophiographie	ophiographie	Nom:Fem+SG
ophiographies	ophiographie	Nom:Fem+PL
ophiolâtrie	ophiolâtrie	Nom:Fem+SG
ophiolâtries	ophiolâtrie	Nom:Fem+PL
ophiolite	ophiolite	Nom:Fem+SG
ophiologie	ophiologie	Nom:Fem+SG
ophiologies	ophiologie	Nom:Fem+PL
ophite	ophite	Nom:Fem+SG
ophite	ophite	Nom:InvGen+SG
ophites	ophite	Nom:Fem+PL
ophites	ophite	Nom:InvGen+PL
ophiure	ophiure	Nom:Fem+SG
ophiures	ophiure	Nom:Fem+PL
ophrys	ophrys	Nom:Mas+InvPL
ophtalmie	ophtalmie	Nom:Fem+SG
ophtalmique	ophtalmique	Adj:InvGen+SG
ophtalmiques	ophtalmique	Adj:InvGen+PL
ophtalmologie	ophtalmologie	Nom:Fem+SG
ophtalmologique	ophtalmologique	Adj:InvGen+SG
ophtalmologiques	ophtalmologique	Adj:InvGen+PL
ophtalmologiste	ophtalmologiste	Nom:InvGen+SG
ophtalmologistes	ophtalmologiste	Nom:InvGen+PL
ophtalmologue	ophtalmologue	Nom:InvGen+SG
ophtalmologues	ophtalmologue	Nom:InvGen+PL
ophtalmomètre	ophtalmomètre	Nom:Mas+SG
ophtalmomètres	ophtalmomètre	Nom:Mas+PL
ophtalmoscope	ophtalmoscope	Nom:Mas+SG
ophtalmoscopie	ophtalmoscopie	Nom:Fem+SG
ophtalmoscopies	ophtalmoscopie	Nom:Fem+PL
opiaçaient	opiacer	Ver:IImp+PL+P3
opiaçai	opiacer	Ver:IPSim+SG+P1
opiaçais	opiacer	Ver:IImp+SG+P1:IImp+SG+P2
opiaçait	opiacer	Ver:IImp+SG+P3
opiaçâmes	opiacer	Ver:IPSim+PL+P1
opiaçant	opiacer	Ver:PPre
opiaça	opiacer	Ver:IPSim+SG+P3
opiaças	opiacer	Ver:IPSim+SG+P2
opiaçassent	opiacer	Ver:SImp+PL+P3
opiaçasse	opiacer	Ver:SImp+SG+P1
opiaçasses	opiacer	Ver:SImp+SG+P2
opiaçassiez	opiacer	Ver:SImp+PL+P2
opiaçassions	opiacer	Ver:SImp+PL+P1
opiaçâtes	opiacer	Ver:IPSim+PL+P2
opiaçât	opiacer	Ver:SImp+SG+P3
opiacée	opiacé	Adj:Fem+SG
opiacées	opiacé	Adj:Fem+PL
opiacent	opiacer	Ver:IPre+PL+P3:SPre+PL+P3
opiacé	opiacé	Adj:Mas+SG
opiacé	opiacé	Nom:Mas+SG
opiace	opiacer	Ver:IPre+SG+P1:IPre+SG+P3:SPre+SG+P1:SPre+SG+P3:ImPre+SG+P2
opiacé	opiacer	Ver:PPas+Mas+SG
opiacèrent	opiacer	Ver:IPSim+PL+P3
opiacer	opiacer	Ver:Inf
opiaces	opiacer	Ver:IPre+SG+P2:SPre+SG+P2
opiacez	opiacer	Ver:IPre+PL+P2:ImPre+PL+P2
opiaciez	opiacer	Ver:IImp+PL+P2:SPre+PL+P2
opiacions	opiacer	Ver:IImp+PL+P1:SPre+PL+P1
opiaçons	opiacer	Ver:Imp+PL+P1
opiaçons	opiacer	Ver:IPre+PL+P1
opiat	opiat	Nom:Mas+SG
opilions	opilion	Nom:Mas+PL
opimes	opimes	Adj:Fem+PL
opinaient	opiner	Ver:IImp+PL+P3
opinai	opiner	Ver:IPSim+SG+P1
opinais	opiner	Ver:IImp+SG+P1:IImp+SG+P2
opinait	opiner	Ver:IImp+SG+P3
opinâmes	opiner	Ver:IPSim+PL+P1
opinant	opiner	Ver:PPre
opina	opiner	Ver:IPSim+SG+P3
opinas	opiner	Ver:IPSim+SG+P2
opinassent	opiner	Ver:SImp+PL+P3
opinasse	opiner	Ver:SImp+SG+P1
opinasses	opiner	Ver:SImp+SG+P2
opinassiez	opiner	Ver:SImp+PL+P2
opinassions	opiner	Ver:SImp+PL+P1
opinâtes	opiner	Ver:IPSim+PL+P2
opinât	opiner	Ver:SImp+SG+P3
opinent	opiner	Ver:IPre+PL+P3:SPre+PL+P3
opine	opiner	Ver:IPre+SG+P1:IPre+SG+P3:SPre+SG+P1:SPre+SG+P3:ImPre+SG+P2
opiné	opiner	Ver:PPas+Mas+SG
opineraient	opiner	Ver:CPre+PL+P3
opinerai	opiner	Ver:IFut+SG+P1
opinerais	opiner	Ver:CPre+SG+P1:CPre+SG+P2
opinerait	opiner	Ver:CPre+SG+P3
opinera	opiner	Ver:IFut+SG+P3
opineras	opiner	Ver:IFut+SG+P2
opinèrent	opiner	Ver:IPSim+PL+P3
opinerez	opiner	Ver:IFut+PL+P2
opineriez	opiner	Ver:CPre+PL+P2
opinerions	opiner	Ver:CPre+PL+P1
opinerons	opiner	Ver:IFut+PL+P1
opineront	opiner	Ver:IFut+PL+P3
opiner	opiner	Ver:Inf
opines	opiner	Ver:IPre+SG+P2:SPre+SG+P2
opinez	opiner	Ver:IPre+PL+P2:ImPre+PL+P2
opiniâtraient	opiniâtrer	Ver:IImp+PL+P3
opiniâtrai	opiniâtrer	Ver:IPSim+SG+P1
opiniâtrais	opiniâtrer	Ver:IImp+SG+P1:IImp+SG+P2
opiniâtrait	opiniâtrer	Ver:IImp+SG+P3
opiniâtrâmes	opiniâtrer	Ver:IPSim+PL+P1
opiniâtrant	opiniâtrer	Ver:PPre
opiniâtra	opiniâtrer	Ver:IPSim+SG+P3
opiniâtras	opiniâtrer	Ver:IPSim+SG+P2
opiniâtrassent	opiniâtrer	Ver:SImp+PL+P3
opiniâtrasse	opiniâtrer	Ver:SImp+SG+P1
opiniâtrasses	opiniâtrer	Ver:SImp+SG+P2
opiniâtrassiez	opiniâtrer	Ver:SImp+PL+P2
opiniâtrassions	opiniâtrer	Ver:SImp+PL+P1
opiniâtrâtes	opiniâtrer	Ver:IPSim+PL+P2
opiniâtrât	opiniâtrer	Ver:SImp+SG+P3
opiniâtrement	opiniâtrement	Adv
opiniâtrent	opiniâtrer	Ver:IPre+PL+P3:SPre+PL+P3
opiniâtre	opiniâtre	Adj:InvGen+SG
opiniâtre	opiniâtrer	Ver:IPre+SG+P1:IPre+SG+P3:SPre+SG+P1:SPre+SG+P3:ImPre+SG+P2
opiniâtré	opiniâtrer	Ver:PPas
opiniâtré	opiniâtrer	Ver:PPas+Mas+SG
opiniâtreraient	opiniâtrer	Ver:CPre+PL+P3
opiniâtrerai	opiniâtrer	Ver:IFut+SG+P1
opiniâtrerais	opiniâtrer	Ver:CPre+SG+P1:CPre+SG+P2
opiniâtrerait	opiniâtrer	Ver:CPre+SG+P3
opiniâtrera	opiniâtrer	Ver:IFut+SG+P3
opiniâtreras	opiniâtrer	Ver:IFut+SG+P2
opiniâtrèrent	opiniâtrer	Ver:IPSim+PL+P3
opiniâtrerez	opiniâtrer	Ver:IFut+PL+P2
opiniâtreriez	opiniâtrer	Ver:CPre+PL+P2
opiniâtrerions	opiniâtrer	Ver:CPre+PL+P1
opiniâtrerons	opiniâtrer	Ver:IFut+PL+P1
opiniâtreront	opiniâtrer	Ver:IFut+PL+P3
opiniâtrer	opiniâtrer	Ver:Inf
opiniâtres	opiniâtre	Adj:InvGen+PL
opiniâtres	opiniâtrer	Ver:IPre+SG+P2:SPre+SG+P2
opiniâtreté	opiniâtreté	Nom:Fem+SG
opiniâtrez	opiniâtrer	Ver:IPre+PL+P2:ImPre+PL+P2
opiniâtriez	opiniâtrer	Ver:IImp+PL+P2:SPre+PL+P2
opiniâtrions	opiniâtrer	Ver:IImp+PL+P1:SPre+PL+P1
opiniâtrons	opiniâtrer	Ver:IPre+PL+P1:ImPre+PL+P1
opiniez	opiner	Ver:IImp+PL+P2:SPre+PL+P2
opinion	opinion	Nom:Fem+SG
opinions	opiner	Ver:IImp+PL+P1:SPre+PL+P1
opinions	opinion	Nom:Fem+PL
opinions	opinions	Nom:Fem+PL
opinons	opiner	Ver:IPre+PL+P1:ImPre+PL+P1
opiomane	opiomane	Adj:InvGen+SG
opiomane	opiomane	Nom:InvGen+SG
opiomanes	opiomane	Adj:InvGen+PL
opiomanes	opiomane	Nom:InvGen+PL
opiomanie	opiomanie	Nom:Fem+SG
opisthobranches	opisthobranche	Nom:Mas+PL
opisthodome	opisthodome	Nom:Mas+SG
opisthodomes	opisthodome	Nom:Mas+PL
opium	opium	Nom:Mas+SG
opiums	opium	Nom:Mas+PL
opopanax	opopanax	Nom:Mas+InvPL
opossum	opossum	Nom:Mas+SG
opossums	opossum	Nom:Mas+PL
opothérapie	opothérapie	Nom:Fem+SG
opothérapique	opothérapique	Adj:InvGen+SG
oppidum	oppidum	Nom:Mas+SG
oppidums	oppidum	Nom:Mas+PL
opportunément	opportunément	Adv
opportune	opportun	Adj:Fem+SG
opportunes	opportun	Adj:Fem+PL
opportunisme	opportunisme	Nom:Mas+SG
opportuniste	opportuniste	Adj:InvGen+SG
opportunistes	opportuniste	Adj:InvGen+PL
opportunité	opportunité	Nom:Fem+SG
opportunités	opportunité	Nom:Fem+PL
opportun	opportun	Adj:Mas+SG
opportuns	opportun	Adj:Mas+PL
opposabilité	opposabilité	Nom:Fem+SG
opposabilités	opposabilité	Nom:Fem+PL
opposable	opposable	Adj:InvGen+SG
opposables	opposable	Adj:InvGen+PL
opposaient	opposer	Ver:IImp+PL+P3
opposai	opposer	Ver:IPSim+SG+P1
opposais	opposer	Ver:IImp+SG+P1:IImp+SG+P2
opposait	opposer	Ver:IImp+SG+P3
opposâmes	opposer	Ver:IPSim+PL+P1
opposante	opposant	Adj:Fem+SG
opposante	opposant	Nom:Fem+SG
opposantes	opposant	Adj:Fem+PL
opposantes	opposant	Nom:Fem+PL
opposant	opposant	Adj:Mas+SG
opposant	opposant	Nom:Mas+SG
opposant	opposer	Ver:PPre
opposants	opposant	Adj:Mas+PL
opposants	opposant	Nom:Mas+PL
opposa	opposer	Ver:IPSim+SG+P3
opposas	opposer	Ver:IPSim+SG+P2
opposassent	opposer	Ver:SImp+PL+P3
opposasse	opposer	Ver:SImp+SG+P1
opposasses	opposer	Ver:SImp+SG+P2
opposassiez	opposer	Ver:SImp+PL+P2
opposassions	opposer	Ver:SImp+PL+P1
opposâtes	opposer	Ver:IPSim+PL+P2
opposât	opposer	Ver:SImp+SG+P3
opposée	opposé	Adj:Fem+SG
opposée	opposer	Ver:PPas+Fem+SG
opposées	opposé	Adj:Fem+PL
opposées	opposer	Ver:PPas+Fem+PL
opposent	opposer	Ver:IPre+PL+P3:SPre+PL+P3
opposé	opposé	Adj:Mas+SG
opposé	opposé	Nom:Mas+SG
oppose	opposer	Ver:IPre+SG+P1:IPre+SG+P3:SPre+SG+P1:SPre+SG+P3:ImPre+SG+P2
opposé	opposer	Ver:PPas+Mas+SG
opposeraient	opposer	Ver:CPre+PL+P3
opposerai	opposer	Ver:IFut+SG+P1
opposerais	opposer	Ver:CPre+SG+P1:CPre+SG+P2
opposerait	opposer	Ver:CPre+SG+P3
opposera	opposer	Ver:IFut+SG+P3
opposeras	opposer	Ver:IFut+SG+P2
opposèrent	opposer	Ver:IPSim+PL+P3
opposerez	opposer	Ver:IFut+PL+P2
opposeriez	opposer	Ver:CPre+PL+P2
opposerions	opposer	Ver:CPre+PL+P1
opposerons	opposer	Ver:IFut+PL+P1
opposeront	opposer	Ver:IFut+PL+P3
opposer	opposer	Ver:Inf
opposés	opposé	Adj:Mas+PL
opposés	opposé	Nom:Mas+PL
opposes	opposer	Ver:IPre+SG+P2:SPre+SG+P2
opposés	opposer	Ver:PPas+Mas+PL
opposez	opposer	Ver:IPre+PL+P2:ImPre+PL+P2
opposiez	opposer	Ver:IImp+PL+P2:SPre+PL+P2
opposions	opposer	Ver:IImp+PL+P1:SPre+PL+P1
opposite	opposite	Adj:InvGen+SG
opposite	opposite	Nom:Mas+SG
oppositionnelle	oppositionnel	Adj:Fem+SG
oppositionnelle	oppositionnel	Nom:Fem+SG
oppositionnelles	oppositionnel	Adj:Fem+PL
oppositionnelles	oppositionnel	Nom:Fem+PL
oppositionnel	oppositionnel	Adj:Mas+SG
oppositionnel	oppositionnel	Nom:Mas+SG
oppositionnels	oppositionnel	Adj:Mas+PL
opposition	opposition	Nom:Fem+SG
oppositions	opposition	Nom:Fem+PL
opposons	opposer	Ver:IPre+PL+P1:ImPre+PL+P1
oppressaient	oppresser	Ver:IImp+PL+P3
oppressai	oppresser	Ver:IPSim+SG+P1
oppressais	oppresser	Ver:IImp+SG+P1
oppressais	oppresser	Ver:IImp+SG+P2
oppressait	oppresser	Ver:IImp+SG+P3
oppressâmes	oppresser	Ver:IPSim+PL+P1
oppressante	oppressant	Adj:Fem+SG
oppressantes	oppressant	Adj:Fem+PL
oppressant	oppressant	Adj:Mas+SG
oppressant	oppresser	Ver:PPre
oppressants	oppressant	Adj:Mas+PL
oppressa	oppresser	Ver:IPSim+SG+P3
oppressas	oppresser	Ver:IPSim+SG+P2
oppressassent	oppresser	Ver:SImp+PL+P3
oppressasse	oppresser	Ver:SImp+SG+P1
oppressasses	oppresser	Ver:SImp+SG+P2
oppressassiez	oppresser	Ver:SImp+PL+P2
oppressassions	oppresser	Ver:SImp+PL+P1
oppressâtes	oppresser	Ver:IPSim+PL+P2
oppressât	oppresser	Ver:SImp+SG+P3
oppressée	oppressé	Adj:Fem+SG
oppressées	oppressé	Adj:Fem+PL
oppressent	oppresser	Ver:IPre+PL+P3:SPre+PL+P3
oppressé	oppressé	Adj:Mas+SG
oppresse	oppresser	Ver:IPre+SG+P1:IPre+SG+P3:SPre+SG+P1:SPre+SG+P3:ImPre+SG+P2
oppressé	oppresser	Ver:PPas+Mas+SG
oppresseraient	oppresser	Ver:CPre+PL+P3
oppresserai	oppresser	Ver:IFut+SG+P1
oppresserais	oppresser	Ver:CPre+SG+P1:CPre+SG+P2
oppresserait	oppresser	Ver:CPre+SG+P3
oppressera	oppresser	Ver:IFut+SG+P3
oppresseras	oppresser	Ver:IFut+SG+P2
oppressèrent	oppresser	Ver:IPSim+PL+P3
oppresserez	oppresser	Ver:IFut+PL+P2
oppresseriez	oppresser	Ver:CPre+PL+P2
oppresserions	oppresser	Ver:CPre+PL+P1
oppresserons	oppresser	Ver:IFut+PL+P1
oppresseront	oppresser	Ver:IFut+PL+P3
oppresser	oppresser	Ver:Inf
oppressés	oppressé	Adj:Mas+PL
oppresses	oppresser	Ver:IPre+SG+P2:SPre+SG+P2
oppressés	oppresser	Ver:PPas+Mas+PL
oppresseur	oppresseur	Adj:Mas+SG
oppresseur	oppresseur	Nom:Mas+SG
oppresseurs	oppresseur	Adj:Mas+PL
oppresseurs	oppresseur	Nom:Mas+PL
oppressez	oppresser	Ver:IPre+PL+P2:ImPre+PL+P2
oppressiez	oppresser	Ver:IImp+PL+P2:SPre+PL+P2
oppressif	oppressif	Adj:Mas+SG
oppressifs	oppressif	Adj:Mas+PL
oppression	oppression	Nom:Fem+SG
oppressions	oppresser	Ver:IImp+PL+P1:SPre+PL+P1
oppressions	oppression	Nom:Fem+PL
oppressive	oppressif	Adj:Fem+SG
oppressives	oppressif	Adj:Fem+PL
oppressons	oppresser	Ver:IPre+PL+P1:ImPre+PL+P1
opprimaient	opprimer	Ver:IImp+PL+P3
opprimai	opprimer	Ver:IPSim+SG+P1
opprimais	opprimer	Ver:IImp+SG+P1:IImp+SG+P2
opprimait	opprimer	Ver:IImp+SG+P3
opprimâmes	opprimer	Ver:IPSim+PL+P1
opprimant	opprimant	Adj:Mas+SG
opprima	opprimer	Ver:IPSim+SG+P3
opprimas	opprimer	Ver:IPSim+SG+P2
opprimassent	opprimer	Ver:SImp+PL+P3
opprimasse	opprimer	Ver:SImp+SG+P1
opprimasses	opprimer	Ver:SImp+SG+P2
opprimassiez	opprimer	Ver:SImp+PL+P2
opprimassions	opprimer	Ver:SImp+PL+P1
opprimâtes	opprimer	Ver:IPSim+PL+P2
opprimât	opprimer	Ver:SImp+SG+P3
opprimée	opprimé	Adj:Fem+SG
opprimée	opprimé	Nom:Fem+SG
opprimée	opprimer	Ver:PPas+Fem+SG
opprimées	opprimé	Adj:Fem+PL
opprimées	opprimé	Nom:Fem+PL
opprimées	opprimer	Ver:PPas+Fem+PL
oppriment	opprimer	Ver:IPre+PL+P3:SPre+PL+P3
opprimé	opprimé	Adj:Mas+SG
opprimé	opprimé	Nom:Mas+SG
opprime	opprimer	Ver:IPre+SG+P1:IPre+SG+P3:SPre+SG+P1:SPre+SG+P3:ImPre+SG+P2
opprimé	opprimer	Ver:PPas+Mas+SG
opprimeraient	opprimer	Ver:CPre+PL+P3
opprimerai	opprimer	Ver:IFut+SG+P1
opprimerais	opprimer	Ver:CPre+SG+P1:CPre+SG+P2
opprimerait	opprimer	Ver:CPre+SG+P3
opprimera	opprimer	Ver:IFut+SG+P3
opprimeras	opprimer	Ver:IFut+SG+P2
opprimèrent	opprimer	Ver:IPSim+PL+P3
opprimerez	opprimer	Ver:IFut+PL+P2
opprimeriez	opprimer	Ver:CPre+PL+P2
opprimerions	opprimer	Ver:CPre+PL+P1
opprimerons	opprimer	Ver:IFut+PL+P1
opprimeront	opprimer	Ver:IFut+PL+P3
opprimer	opprimer	Ver:Inf
opprimés	opprimé	Adj:Mas+PL
opprimés	opprimé	Nom:Mas+PL
opprimes	opprimer	Ver:IPre+SG+P2:SPre+SG+P2
opprimés	opprimer	Ver:PPas+Mas+PL
opprimez	opprimer	Ver:IPre+PL+P2:ImPre+PL+P2
opprimiez	opprimer	Ver:IImp+PL+P2:SPre+PL+P2
opprimions	opprimer	Ver:IImp+PL+P1:SPre+PL+P1
opprimons	opprimer	Ver:IPre+PL+P1:ImPre+PL+P1
opprobre	opprobre	Nom:Mas+SG
opprobres	opprobre	Nom:Mas+PL
optaient	opter	Ver:IImp+PL+P3
optai	opter	Ver:IPSim+SG+P1
optais	opter	Ver:IImp+SG+P1:IImp+SG+P2
optait	opter	Ver:IImp+SG+P3
optâmes	opter	Ver:IPSim+PL+P1
optant	optant	Nom:Mas+SG
optant	opter	Ver:PPre
opta	opter	Ver:IPSim+SG+P3
optas	opter	Ver:IPSim+SG+P2
optassent	opter	Ver:SImp+PL+P3
optasse	opter	Ver:SImp+SG+P1
optasses	opter	Ver:SImp+SG+P2
optassiez	opter	Ver:SImp+PL+P2
optassions	opter	Ver:SImp+PL+P1
optâtes	opter	Ver:IPSim+PL+P2
optatif	optatif	Adj:Mas+SG
optatifs	optatif	Adj:Mas+PL
optative	optatif	Adj:Fem+SG
optât	opter	Ver:SImp+SG+P3
optent	opter	Ver:IPre+PL+P3:SPre+PL+P3
opte	opter	Ver:IPre+SG+P1:IPre+SG+P3:SPre+SG+P1:SPre+SG+P3:ImPre+SG+P2
opté	opter	Ver:PPas+Mas+SG
opteraient	opter	Ver:CPre+PL+P3
opterai	opter	Ver:IFut+SG+P1
opterais	opter	Ver:CPre+SG+P1:CPre+SG+P2
opterait	opter	Ver:CPre+SG+P3
optera	opter	Ver:IFut+SG+P3
opteras	opter	Ver:IFut+SG+P2
optèrent	opter	Ver:IPSim+PL+P3
opterez	opter	Ver:IFut+PL+P2
opteriez	opter	Ver:CPre+PL+P2
opterions	opter	Ver:CPre+PL+P1
opterons	opter	Ver:IFut+PL+P1
opteront	opter	Ver:IFut+PL+P3
opter	opter	Ver:Inf
optes	opter	Ver:IPre+SG+P2
optes	opter	Ver:SPre+SG+P2
optez	opter	Ver:IPre+PL+P2:ImPre+PL+P2
opticienne	opticien	Nom:Fem+SG
opticiennes	opticien	Nom:Fem+PL
opticien	opticien	Nom:Mas+SG
opticiens	opticien	Nom:Mas+PL
optiez	opter	Ver:IImp+PL+P2:SPre+PL+P2
optimale	optimal	Adj:Fem+SG
optimales	optimal	Adj:Fem+PL
optimaliser	optimaliser	Ver:Inf
optimal	optimal	Adj:Mas+SG
optima	optimum	Adj:Fem+SG:InvGen+PL
optima	optimum	Nom:Mas+PL
optimaux	optimal	Adj:Mas+PL
optimisaient	optimiser	Ver:IImp+PL+P3
optimisai	optimiser	Ver:IPSim+SG+P1
optimisais	optimiser	Ver:IImp+SG+P1:IImp+SG+P2
optimisait	optimiser	Ver:IImp+SG+P3
optimisâmes	optimiser	Ver:IPSim+PL+P1
optimisant	optimiser	Ver:PPre
optimisa	optimiser	Ver:IPSim+SG+P3
optimisas	optimiser	Ver:IPSim+SG+P2
optimisassent	optimiser	Ver:SImp+PL+P3
optimisasse	optimiser	Ver:SImp+SG+P1
optimisasses	optimiser	Ver:SImp+SG+P2
optimisassiez	optimiser	Ver:SImp+PL+P2
optimisassions	optimiser	Ver:SImp+PL+P1
optimisâtes	optimiser	Ver:IPSim+PL+P2
optimisation	optimisation	Nom:Fem+SG
optimisations	optimisation	Nom:Fem+PL
optimisât	optimiser	Ver:SImp+SG+P3
optimisée	optimiser	Ver:PPas+Fem+SG
optimisées	optimiser	Ver:PPas+Fem+PL
optimisent	optimiser	Ver:IPre+PL+P3:SPre+PL+P3
optimise	optimiser	Ver:IPre+SG+P1:IPre+SG+P3:SPre+SG+P1:SPre+SG+P3:ImPre+SG+P2
optimisé	optimiser	Ver:PPas+Mas+SG
optimiseraient	optimiser	Ver:CPre+PL+P3
optimiserai	optimiser	Ver:IFut+SG+P1
optimiserais	optimiser	Ver:CPre+SG+P1:CPre+SG+P2
optimiserait	optimiser	Ver:CPre+SG+P3
optimisera	optimiser	Ver:IFut+SG+P3
optimiseras	optimiser	Ver:IFut+SG+P2
optimisèrent	optimiser	Ver:IPSim+PL+P3
optimiserez	optimiser	Ver:IFut+PL+P2
optimiseriez	optimiser	Ver:CPre+PL+P2
optimiserions	optimiser	Ver:CPre+PL+P1
optimiserons	optimiser	Ver:IFut+PL+P1
optimiseront	optimiser	Ver:IFut+PL+P3
optimiser	optimiser	Ver:Inf
optimises	optimiser	Ver:IPre+SG+P2:SPre+SG+P2
optimisés	optimiser	Ver:PPas+Mas+PL
optimisez	optimiser	Ver:IPre+PL+P2:ImPre+PL+P2
optimisiez	optimiser	Ver:IImp+PL+P2:SPre+PL+P2
optimisions	optimiser	Ver:IImp+PL+P1:SPre+PL+P1
optimisme	optimisme	Nom:Mas+SG
optimismes	optimisme	Nom:Mas+PL
optimisons	optimiser	Ver:IPre+PL+P1:ImPre+PL+P1
optimiste	optimiste	Adj:InvGen+SG
optimiste	optimiste	Nom:InvGen+SG
optimistes	optimiste	Adj:InvGen+PL
optimistes	optimiste	Nom:InvGen+PL
optimum	optimum	Adj:InvGen+SG
optimum	optimum	Nom:Mas+SG
optimums	optimum	Adj:InvGen+PL
optimums	optimum	Nom:Mas+PL
optionnelle	optionnel	Adj:Fem+SG
optionnelles	optionnel	Adj:Fem+PL
optionnel	optionnel	Adj:Mas+SG
optionnels	optionnel	Adj:Mas+PL
option	option	Nom:Fem+SG
options	opter	Ver:IImp+PL+P1:SPre+PL+P1
options	option	Nom:Fem+PL
optique	optique	Adj:InvGen+SG
optique	optique	Nom:Fem+SG
optiques	optique	Adj:InvGen+PL
optiques	optique	Nom:Fem+PL
optométrie	optométrie	Nom:Fem+SG
optométries	optométrie	Nom:Fem+PL
optons	opter	Ver:IPre+PL+P1:ImPre+PL+P1
opulemment	opulemment	Adv
opulence	opulence	Nom:Fem+SG
opulente	opulent	Adj:Fem+SG
opulentes	opulent	Adj:Fem+PL
opulent	opulent	Adj:Mas+SG
opulents	opulent	Adj:Mas+PL
opuntia	opuntia	Nom:Mas+SG
opuntias	opuntia	Nom:Mas+PL
opuscule	opuscule	Nom:Mas+SG
opuscules	opuscule	Nom:Mas+PL
opus	opus	Nom:Mas+InvPL
oracle	oracle	Nom:Mas+SG
oracles	oracle	Nom:Mas+PL
orage	orage	Nom:Mas+SG
orages	orage	Nom:Mas+PL
orageusement	orageusement	Adv
orageuse	orageux	Adj:Fem+SG
orageuses	orageux	Adj:Fem+PL
orageux	orageux	Adj:Mas+InvPL
oraison	oraison	Nom:Fem+SG
oraisons	oraison	Nom:Fem+PL
oralement	oralement	Adv
orale	oral	Adj:Fem+SG
orale	orale	Nom:Fem+SG
orales	oral	Adj:Fem+PL
orales	orale	Nom:Fem+PL
oral	oral	Adj:Mas+SG
oral	oral	Nom:Mas+SG
oranais	oranais	Adj:Mas+InvPL
oranais	oranais	Nom:Mas+InvPL
orangeade	orangeade	Nom:Fem+SG
orangeades	orangeade	Nom:Fem+PL
orangée	orangé	Adj:Fem+SG
orangée	oranger	Ver:PPas+Fem+SG
orangées	orangé	Adj:Fem+PL
orangées	oranger	Ver:PPas+Fem+PL
orange	orange	Adj:InvGen+SG:InvGen+PL
orangé	orangé	Adj:Mas+SG
orange	orange	Nom:Fem+SG
orange	orange	Nom:Mas+SG
orangé	orangé	Nom:Mas+SG
orange	oranger	Ver:IPre+SG+P1:IPre+SG+P3:SPre+SG+P1:SPre+SG+P3:ImPre+SG+P2
orangé	oranger	Ver:PPas+Mas+SG
orangeraie	orangeraie	Nom:Fem+SG
orangeraies	orangeraie	Nom:Fem+PL
orangerie	orangerie	Nom:Fem+SG
orangeries	orangerie	Nom:Fem+PL
oranger	oranger	Nom:Mas+SG
oranger	oranger	Ver:Inf
orangers	oranger	Nom:Mas+PL
orangés	orangé	Adj:Mas+PL
oranges	orange	Nom:Fem+PL
oranges	orange	Nom:Mas+PL
orangés	orangé	Nom:Mas+PL
oranges	oranger	Ver:IPre+SG+P2:SPre+SG+P2
orangés	oranger	Ver:PPas+Mas+PL
orangiste	orangiste	Adj:InvGen+SG
orangiste	orangiste	Nom:InvGen+SG
orangistes	orangiste	Adj:InvGen+PL
orangistes	orangiste	Nom:InvGen+PL
orang	orang	Nom:Mas+SG
orangs	orang	Nom:Mas+PL
orangs-outangs	orang-outang	Nom:Mas+PL
orangs-outans	orang-outan	Nom:Mas+PL
orang-outang	orang-outang	Nom:Mas+SG
orang-outan	orang-outan	Nom:Mas+SG
orante	orant	Adj:Fem+SG
orante	orant	Nom:Fem+SG
orantes	orant	Adj:Fem+PL
orantes	orant	Nom:Fem+PL
orant	orant	Adj:Mas+SG
orants	orant	Adj:Mas+PL
orants	orant	Nom:Mas+PL
orateur	orateur	Nom:Mas+SG
orateurs	orateur	Nom:Mas+PL
oratoire	oratoire	Adj:InvGen+SG
oratoire	oratoire	Nom:Mas+SG
oratoires	oratoire	Adj:InvGen+PL
oratoires	oratoire	Nom:Mas+PL
oratorien	oratorien	Adj:Mas+SG
oratoriens	oratorien	Adj:Mas+PL
oratorio	oratorio	Nom:Mas+SG
oratorios	oratorio	Nom:Mas+PL
oratrice	orateur	Nom:Fem+SG
oratrices	orateur	Nom:Fem+PL
oraux	oral	Adj:Mas+PL
oraux	oral	Nom:Mas+PL
orbe	orbe	Adj:InvGen+SG
orbes	orbe	Nom:Mas+PL
orbicole	orbicole	Adj:InvGen+SG
orbiculaire	orbiculaire	Adj:InvGen+SG
orbitaire	orbitaire	Adj:InvGen+SG
orbitaires	orbitaire	Adj:InvGen+PL
orbitale	orbitale	Nom:Fem+SG
orbitales	orbitale	Nom:Fem+PL
orbital	orbital	Adj:Mas+SG
orbitaux	orbital	Adj:Mas+PL
orbite	orbite	Nom:Fem+SG
orbite	orbiter	Ver:IPre+SG+P1:IPre+SG+P3:SPre+SG+P1:SPre+SG+P3:ImPre+SG+P2
orbiter	orbiter	Ver:Inf
orbites	orbite	Nom:Fem+PL
orbites	orbiter	Ver:IPre+SG+P2:SPre+SG+P2
orcanette	orcanette	Nom:Fem+SG
orcanettes	orcanette	Nom:Fem+PL
orchestique	orchestique	Adj:InvGen+SG
orchestique	orchestique	Nom:Fem+SG
orchestraient	orchestrer	Ver:IImp+PL+P3
orchestrai	orchestrer	Ver:IPSim+SG+P1
orchestrais	orchestrer	Ver:IImp+SG+P1:IImp+SG+P2
orchestrait	orchestrer	Ver:IImp+SG+P3
orchestrale	orchestral	Adj:Fem+SG
orchestrales	orchestral	Adj:Fem+PL
orchestral	orchestral	Adj:Mas+SG
orchestrâmes	orchestrer	Ver:IPSim+PL+P1
orchestrant	orchestrer	Ver:PPre
orchestra	orchestrer	Ver:IPSim+SG+P3
orchestras	orchestrer	Ver:IPSim+SG+P2
orchestrassent	orchestrer	Ver:SImp+PL+P3
orchestrasse	orchestrer	Ver:SImp+SG+P1
orchestrasses	orchestrer	Ver:SImp+SG+P2
orchestrassiez	orchestrer	Ver:SImp+PL+P2
orchestrassions	orchestrer	Ver:SImp+PL+P1
orchestrâtes	orchestrer	Ver:IPSim+PL+P2
orchestrateur	orchestrateur	Nom:Mas+SG
orchestration	orchestration	Nom:Fem+SG
orchestrations	orchestration	Nom:Fem+PL
orchestrât	orchestrer	Ver:SImp+SG+P3
orchestraux	orchestral	Adj:Mas+PL
orchestrée	orchestrer	Ver:PPas+Fem+SG
orchestrées	orchestrer	Ver:PPas+Fem+PL
orchestrent	orchestrer	Ver:IPre+PL+P3:SPre+PL+P3
orchestre	orchestre	Nom:Mas+SG
orchestre	orchestrer	Ver:IPre+SG+P1:IPre+SG+P3:SPre+SG+P1:SPre+SG+P3:ImPre+SG+P2
orchestré	orchestrer	Ver:PPas+Mas+SG
orchestreraient	orchestrer	Ver:CPre+PL+P3
orchestrerai	orchestrer	Ver:IFut+SG+P1
orchestrerais	orchestrer	Ver:CPre+SG+P1:CPre+SG+P2
orchestrerait	orchestrer	Ver:CPre+SG+P3
orchestrera	orchestrer	Ver:IFut+SG+P3
orchestreras	orchestrer	Ver:IFut+SG+P2
orchestrèrent	orchestrer	Ver:IPSim+PL+P3
orchestrerez	orchestrer	Ver:IFut+PL+P2
orchestreriez	orchestrer	Ver:CPre+PL+P2
orchestrerions	orchestrer	Ver:CPre+PL+P1
orchestrerons	orchestrer	Ver:IFut+PL+P1
orchestreront	orchestrer	Ver:IFut+PL+P3
orchestrer	orchestrer	Ver:Inf
orchestres	orchestre	Nom:Mas+PL
orchestres	orchestrer	Ver:IPre+SG+P2:SPre+SG+P2
orchestrés	orchestrer	Ver:PPas+Mas+PL
orchestrez	orchestrer	Ver:IPre+PL+P2:ImPre+PL+P2
orchestriez	orchestrer	Ver:IImp+PL+P2:SPre+PL+P2
orchestrions	orchestrer	Ver:IImp+PL+P1:SPre+PL+P1
orchestrons	orchestrer	Ver:IPre+PL+P1:ImPre+PL+P1
orchidacées	orchidacée	Nom:Fem+PL
orchidée	orchidée	Nom:Fem+SG
orchidées	orchidée	Nom:Fem+PL
orchis	orchis	Nom:Mas+InvPL
orchite	orchite	Nom:Fem+SG
ordalie	ordalie	Nom:Fem+SG
ordalies	ordalie	Nom:Fem+PL
ordinairement	ordinairement	Adv
ordinaire	ordinaire	Adj:InvGen+SG
ordinaire	ordinaire	Nom:Mas+SG
ordinaires	ordinaire	Adj:InvGen+PL
ordinaires	ordinaire	Nom:Mas+PL
ordinale	ordinal	Adj:Fem+SG
ordinales	ordinal	Adj:Fem+PL
ordinal	ordinal	Adj:Mas+SG
ordinand	ordinand	Nom:Mas+SG
ordinands	ordinand	Nom:Mas+PL
ordinant	ordinant	Nom:Mas+SG
ordinateur	ordinateur	Nom:Mas+SG
ordinateurs	ordinateur	Nom:Mas+PL
ordination	ordination	Nom:Fem+SG
ordinations	ordination	Nom:Fem+PL
ordinaux	ordinal	Adj:Mas+PL
ordonnaient	ordonner	Ver:IImp+PL+P3
ordonnai	ordonner	Ver:IPSim+SG+P1
ordonnais	ordonner	Ver:IImp+SG+P1
ordonnais	ordonner	Ver:IImp+SG+P2
ordonnait	ordonner	Ver:IImp+SG+P3
ordonnâmes	ordonner	Ver:IPSim+PL+P1
ordonnançaient	ordonnancer	Ver:IImp+PL+P3
ordonnançai	ordonnancer	Ver:IPSim+SG+P1
ordonnançais	ordonnancer	Ver:IImp+SG+P1:IImp+SG+P2
ordonnançait	ordonnancer	Ver:IImp+SG+P3
ordonnançâmes	ordonnancer	Ver:IPSim+PL+P1
ordonnançant	ordonnancer	Ver:PPre
ordonnança	ordonnancer	Ver:IPSim+SG+P3
ordonnanças	ordonnancer	Ver:IPSim+SG+P2
ordonnançassent	ordonnancer	Ver:SImp+PL+P3
ordonnançasse	ordonnancer	Ver:SImp+SG+P1
ordonnançasses	ordonnancer	Ver:SImp+SG+P2
ordonnançassiez	ordonnancer	Ver:SImp+PL+P2
ordonnançassions	ordonnancer	Ver:SImp+PL+P1
ordonnançâtes	ordonnancer	Ver:IPSim+PL+P2
ordonnançât	ordonnancer	Ver:SImp+SG+P3
ordonnancée	ordonnancer	Ver:PPas+Fem+SG
ordonnancées	ordonnancer	Ver:PPas+Fem+PL
ordonnancement	ordonnancement	Nom:Mas+SG
ordonnancements	ordonnancement	Nom:Mas+PL
ordonnancent	ordonnancer	Ver:IPre+PL+P3:SPre+PL+P3
ordonnance	ordonnance	Nom:Fem+SG
ordonnance	ordonnance	Nom:InvGen+SG
ordonnance	ordonnancer	Ver:IPre+SG+P1:IPre+SG+P3:SPre+SG+P1:SPre+SG+P3:ImPre+SG+P2
ordonnancé	ordonnancer	Ver:PPas+Mas+SG
ordonnanceraient	ordonnancer	Ver:CPre+PL+P3
ordonnancerai	ordonnancer	Ver:IFut+SG+P1
ordonnancerais	ordonnancer	Ver:CPre+SG+P1:CPre+SG+P2
ordonnancerait	ordonnancer	Ver:CPre+SG+P3
ordonnancera	ordonnancer	Ver:IFut+SG+P3
ordonnanceras	ordonnancer	Ver:IFut+SG+P2
ordonnancèrent	ordonnancer	Ver:IPSim+PL+P3
ordonnancerez	ordonnancer	Ver:IFut+PL+P2
ordonnanceriez	ordonnancer	Ver:CPre+PL+P2
ordonnancerions	ordonnancer	Ver:CPre+PL+P1
ordonnancerons	ordonnancer	Ver:IFut+PL+P1
ordonnanceront	ordonnancer	Ver:IFut+PL+P3
ordonnancer	ordonnancer	Ver:Inf
ordonnances	ordonnance	Nom:Fem+PL
ordonnances	ordonnance	Nom:InvGen+PL
ordonnances	ordonnancer	Ver:IPre+SG+P2:SPre+SG+P2
ordonnancés	ordonnancer	Ver:PPas+Mas+PL
ordonnances	ordonnances	Nom:Fem+PL
ordonnancez	ordonnancer	Ver:IPre+PL+P2:ImPre+PL+P2
ordonnanciez	ordonnancer	Ver:IImp+PL+P2:SPre+PL+P2
ordonnancions	ordonnancer	Ver:IImp+PL+P1:SPre+PL+P1
ordonnançons	ordonnancer	Ver:IPre+PL+P1:ImPre+PL+P1
ordonnant	ordonner	Ver:PPre
ordonna	ordonner	Ver:IPSim+SG+P3
ordonnas	ordonner	Ver:IPSim+SG+P2
ordonnassent	ordonner	Ver:SImp+PL+P3
ordonnasse	ordonner	Ver:SImp+SG+P1
ordonnasses	ordonner	Ver:SImp+SG+P2
ordonnassiez	ordonner	Ver:SImp+PL+P2
ordonnassions	ordonner	Ver:SImp+PL+P1
ordonnâtes	ordonner	Ver:IPSim+PL+P2
ordonnateur	ordonnateur	Nom:Mas+SG
ordonnateurs	ordonnateur	Nom:Mas+PL
ordonnât	ordonner	Ver:SImp+SG+P3
ordonnatrice	ordonnateur	Nom:Fem+SG
ordonnatrices	ordonnateur	Nom:Fem+PL
ordonnée	ordonné	Adj:Fem+SG
ordonnée	ordonnée	Nom:Fem+SG
ordonnée	ordonner	Ver:PPas+Fem+SG
ordonnées	ordonné	Adj:Fem+PL
ordonnées	ordonnée	Nom:Fem+PL
ordonnées	ordonner	Ver:PPas+Fem+PL
ordonnent	ordonner	Ver:IPre+PL+P3:SPre+PL+P3
ordonné	ordonné	Adj:Mas+SG
ordonne	ordonner	Ver:IPre+SG+P1:IPre+SG+P3:SPre+SG+P1:SPre+SG+P3:ImPre+SG+P2
ordonné	ordonner	Ver:PPas+Mas+SG
ordonneraient	ordonner	Ver:CPre+PL+P3
ordonnerai	ordonner	Ver:IFut+SG+P1
ordonnerais	ordonner	Ver:CPre+SG+P1:CPre+SG+P2
ordonnerait	ordonner	Ver:CPre+SG+P3
ordonnera	ordonner	Ver:IFut+SG+P3
ordonneras	ordonner	Ver:IFut+SG+P2
ordonnèrent	ordonner	Ver:IPSim+PL+P3
ordonnerez	ordonner	Ver:IFut+PL+P2
ordonneriez	ordonner	Ver:CPre+PL+P2
ordonnerions	ordonner	Ver:CPre+PL+P1
ordonnerons	ordonner	Ver:IFut+PL+P1
ordonneront	ordonner	Ver:IFut+PL+P3
ordonner	ordonner	Ver:Inf
ordonnés	ordonné	Adj:Mas+PL
ordonnes	ordonner	Ver:IPre+SG+P2:SPre+SG+P2
ordonnés	ordonner	Ver:PPas+Mas+PL
ordonnez	ordonner	Ver:Imp+PL+P2
ordonnez	ordonner	Ver:IPre+PL+P2
ordonniez	ordonner	Ver:IImp+PL+P2
ordonniez	ordonner	Ver:SPre+PL+P2
ordonnions	ordonner	Ver:IImp+PL+P1
ordonnions	ordonner	Ver:SPre+PL+P1
ordonnons	ordonner	Ver:Imp+PL+P1
ordonnons	ordonner	Ver:IPre+PL+P1
ordo	ordo	Nom:Mas+InvPL
ordovicien	ordovicien	Adj:Mas+SG
ordovicien	ordovicien	Nom:Mas+SG
ordoviciens	ordovicien	Adj:Mas+PL
ordoviciens	ordovicien	Nom:Mas+PL
ordre	ordre	Nom:Mas+SG
ordres	ordre	Nom:Mas+PL
ordure	ordure	Nom:Fem+SG
ordures	ordure	Nom:Fem+PL
ordures	ordures	Nom:Fem+PL
ordurière	ordurier	Adj:Fem+SG
ordurières	ordurier	Adj:Fem+PL
ordurier	ordurier	Adj:Mas+SG
orduriers	ordurier	Adj:Mas+PL
oréade	oréade	Nom:Fem+SG
orée	orée	Nom:Fem+SG
orées	orée	Nom:Fem+PL
oreillarde	oreillard	Adj:Fem+SG
oreillardes	oreillard	Adj:Fem+PL
oreillard	oreillard	Adj:Mas+SG
oreillards	oreillard	Adj:Mas+PL
oreille	oreille	Nom:Fem+SG
oreiller	oreiller	Nom:Mas+SG
oreillers	oreiller	Nom:Mas+PL
oreilles	oreille	Nom:Fem+PL
oreilles-de-mer	oreille-de-mer	Nom:Fem+PL
oreilles-de-souris	oreille-de-souris	Nom:Fem+PL
oreillette	oreillette	Nom:Fem+SG
oreillettes	oreillette	Nom:Fem+PL
oreille-de-mer	oreille-de-mer	Nom:Fem+SG
oreille-de-souris	oreille-de-souris	Nom:Fem+SG
oreillon	oreillon	Nom:Mas+SG
oreillons	oreillon	Nom:Mas+PL
oreillons	oreillons	Nom:Mas+PL
oréopithèque	oréopithèque	Nom:Mas+SG
ores	ores	Adv
orfèvre	orfèvre	Nom:InvGen+SG
orfèvre	orfévrer	Ver:IPre+SG+P1:IPre+SG+P3:SPre+SG+P1:SPre+SG+P3:ImPre+SG+P2
orfèvrerie	orfèvrerie	Nom:Fem+SG
orfèvreries	orfèvrerie	Nom:Fem+PL
orfèvres	orfèvre	Nom:InvGen+PL
orfèvres	orfévrer	Ver:IPre+SG+P2:SPre+SG+P2
orfraie	orfraie	Nom:Fem+SG
orfraies	orfraie	Nom:Fem+PL
orfroi	orfroi	Nom:Mas+SG
organdi	organdi	Nom:Mas+SG
organdis	organdi	Nom:Mas+PL
organeau	organeau	Nom:Mas+SG
organeaux	organeau	Nom:Mas+PL
organe	organe	Nom:Mas+SG
organes	organes	Nom:Mas+PL
organicisme	organicisme	Nom:Mas+SG
organiciste	organiciste	Adj:InvGen+SG
organiciste	organiciste	Nom:InvGen+SG
organigramme	organigramme	Nom:Mas+SG
organigrammes	organigramme	Nom:Mas+PL
organiquement	organiquement	Adv
organique	organique	Adj:InvGen+SG
organiques	organique	Adj:InvGen+PL
organisable	organisable	Adj:InvGen+SG
organisables	organisable	Adj:InvGen+PL
organisaient	organiser	Ver:IImp+PL+P3
organisai	organiser	Ver:IPSim+SG+P1
organisais	organiser	Ver:IImp+SG+P1:IImp+SG+P2
organisait	organiser	Ver:IImp+SG+P3
organisâmes	organiser	Ver:IPSim+PL+P1
organisant	organiser	Ver:PPre
organisa	organiser	Ver:IPSim+SG+P3
organisas	organiser	Ver:IPSim+SG+P2
organisassent	organiser	Ver:SImp+PL+P3
organisasse	organiser	Ver:SImp+SG+P1
organisasses	organiser	Ver:SImp+SG+P2
organisassiez	organiser	Ver:SImp+PL+P2
organisassions	organiser	Ver:SImp+PL+P1
organisâtes	organiser	Ver:IPSim+PL+P2
organisateur	organisateur	Adj:Mas+SG
organisateurs	organisateur	Adj:Mas+PL
organisationnelle	organisationnel	Adj:Fem+SG
organisationnel	organisationnel	Adj:Mas+SG
organisation	organisation	Nom:Fem+SG
organisations	organisation	Nom:Fem+PL
organisât	organiser	Ver:SImp+SG+P3
organisatrice	organisateur	Adj:Fem+SG
organisatrice	organisateur	Nom:Fem+SG
organisatrices	organisateur	Adj:Fem+PL
organisatrices	organisateur	Nom:Fem+PL
organisée	organisé	Adj:Fem+SG
organisée	organiser	Ver:PPas+Fem+SG
organisées	organisé	Adj:Fem+PL
organisées	organiser	Ver:PPas+Fem+PL
organisent	organiser	Ver:IPre+PL+P3:SPre+PL+P3
organisé	organisé	Adj:Mas+SG
organise	organiser	Ver:IPre+SG+P1:IPre+SG+P3:SPre+SG+P1:SPre+SG+P3:ImPre+SG+P2
organisé	organiser	Ver:PPas+Mas+SG
organiseraient	organiser	Ver:CPre+PL+P3
organiserai	organiser	Ver:IFut+SG+P1
organiserais	organiser	Ver:CPre+SG+P1:CPre+SG+P2
organiserait	organiser	Ver:CPre+SG+P3
organisera	organiser	Ver:IFut+SG+P3
organiseras	organiser	Ver:IFut+SG+P2
organisèrent	organiser	Ver:IPSim+PL+P3
organiserez	organiser	Ver:IFut+PL+P2
organiseriez	organiser	Ver:CPre+PL+P2
organiserions	organiser	Ver:CPre+PL+P1
organiserons	organiser	Ver:IFut+PL+P1
organiseront	organiser	Ver:IFut+PL+P3
organiser	organiser	Ver:Inf
organisés	organisé	Adj:Mas+PL
organises	organiser	Ver:IPre+SG+P2:SPre+SG+P2
organisés	organiser	Ver:PPas+Mas+PL
organisez	organiser	Ver:IPre+PL+P2:ImPre+PL+P2
organisiez	organiser	Ver:IImp+PL+P2:SPre+PL+P2
organisions	organiser	Ver:IImp+PL+P1:SPre+PL+P1
organisme	organisme	Nom:Mas+SG
organismes	organisme	Nom:Mas+PL
organisons	organiser	Ver:IPre+PL+P1:ImPre+PL+P1
organiste	organiste	Nom:InvGen+SG
organistes	organiste	Nom:InvGen+PL
organite	organite	Nom:Mas+SG
organites	organite	Nom:Mas+PL
organologie	organologie	Nom:Fem+SG
organothérapie	organothérapie	Nom:Fem+SG
organsinage	organsinage	Nom:Mas+SG
organsinages	organsinage	Nom:Mas+PL
organsinaient	organsiner	Ver:IImp+PL+P3
organsinai	organsiner	Ver:IPSim+SG+P1
organsinais	organsiner	Ver:IImp+SG+P1:IImp+SG+P2
organsinait	organsiner	Ver:IImp+SG+P3
organsinâmes	organsiner	Ver:IPSim+PL+P1
organsinant	organsiner	Ver:PPre
organsina	organsiner	Ver:IPSim+SG+P3
organsinas	organsiner	Ver:IPSim+SG+P2
organsinassent	organsiner	Ver:SImp+PL+P3
organsinasse	organsiner	Ver:SImp+SG+P1
organsinasses	organsiner	Ver:SImp+SG+P2
organsinassiez	organsiner	Ver:SImp+PL+P2
organsinassions	organsiner	Ver:SImp+PL+P1
organsinâtes	organsiner	Ver:IPSim+PL+P2
organsinât	organsiner	Ver:SImp+SG+P3
organsinent	organsiner	Ver:IPre+PL+P3:SPre+PL+P3
organsine	organsiner	Ver:IPre+SG+P1:IPre+SG+P3:SPre+SG+P1:SPre+SG+P3:ImPre+SG+P2
organsiné	organsiner	Ver:PPas+Mas+SG
organsinèrent	organsiner	Ver:IPSim+PL+P3
organsiner	organsiner	Ver:Inf
organsines	organsiner	Ver:IPre+SG+P2:SPre+SG+P2
organsinez	organsiner	Ver:IPre+PL+P2:ImPre+PL+P2
organsiniez	organsiner	Ver:IImp+PL+P2:SPre+PL+P2
organsinions	organsiner	Ver:IImp+PL+P1:SPre+PL+P1
organsinons	organsiner	Ver:IPre+PL+P1:ImPre+PL+P1
organsin	organsin	Nom:Mas+SG
organsins	organsin	Nom:Mas+PL
orgasme	orgasme	Nom:Mas+SG
orgasmes	orgasme	Nom:Mas+PL
orgastique	orgastique	Adj:InvGen+SG
orgeat	orgeat	Nom:Mas+SG
orgeats	orgeat	Nom:Mas+PL
orgelet	orgelet	Nom:Mas+SG
orgelets	orgelet	Nom:Mas+PL
orge	orge	Nom:Fem+SG
orge	orge	Nom:Mas+SG
orges	orge	Nom:Fem+PL
orges	orge	Nom:Mas+PL
orgiaque	orgiaque	Adj:InvGen+SG
orgiaques	orgiaque	Adj:InvGen+PL
orgie	orgie	Nom:Fem+SG
orgies	orgie	Nom:Fem+PL
orgies	orgies	Nom:Fem+PL
orgueilleusement	orgueilleusement	Adv
orgueilleuse	orgueilleux	Adj:Fem+SG
orgueilleuse	orgueilleux	Nom:Fem+SG
orgueilleuses	orgueilleux	Adj:Fem+PL
orgueilleuses	orgueilleux	Nom:Fem+PL
orgueilleux	orgueilleux	Adj:Mas+InvPL
orgueilleux	orgueilleux	Nom:Mas+InvPL
orgueil	orgueil	Nom:Mas+SG
orgueils	orgueil	Nom:Mas+PL
orgue	orgue	Nom:Mas+SG
orgues	orgue	Nom:InvGen+PL
orgues	orgues	Nom:Fem+PL
oribus	oribus	Nom:Mas+InvPL
orichalque	orichalque	Nom:Mas+SG
oriel	oriel	Nom:Mas+SG
orientable	orientable	Adj:InvGen+SG
orientables	orientable	Adj:InvGen+PL
orientaient	orienter	Ver:IImp+PL+P3
orientai	orienter	Ver:IPSim+SG+P1
orientais	orienter	Ver:IImp+SG+P1:IImp+SG+P2
orientait	orienter	Ver:IImp+SG+P3
orientale	oriental	Adj:Fem+SG
orientales	oriental	Adj:Fem+PL
orientalisant	orientaliser	Ver:PPre
orientalisant	orientaliser	Ver:PPre+Mas+SG
orientaliser	orientaliser	Ver:Inf
orientalisme	orientalisme	Nom:Mas+SG
orientaliste	orientaliste	Nom:InvGen+SG
orientalistes	orientaliste	Nom:InvGen+PL
oriental	oriental	Adj:Mas+SG
oriental	oriental	Nom:Mas+SG
orientâmes	orienter	Ver:IPSim+PL+P1
orientant	orienter	Ver:PPre
orienta	orienter	Ver:IPSim+SG+P3
orientas	orienter	Ver:IPSim+SG+P2
orientassent	orienter	Ver:SImp+PL+P3
orientasse	orienter	Ver:SImp+SG+P1
orientasses	orienter	Ver:SImp+SG+P2
orientassiez	orienter	Ver:SImp+PL+P2
orientassions	orienter	Ver:SImp+PL+P1
orientâtes	orienter	Ver:IPSim+PL+P2
orientation	orientation	Nom:Fem+SG
orientations	orientation	Nom:Fem+PL
orientât	orienter	Ver:SImp+SG+P3
orientaux	oriental	Adj:Mas+PL
orientaux	oriental	Nom:Mas+PL
orientée	orienté	Adj:Fem+SG
orientée	orienter	Ver:PPas+Fem+SG
orientées	orienté	Adj:Fem+PL
orientées	orienter	Ver:PPas+Fem+PL
orientement	orientement	Nom:Mas+SG
orientent	orienter	Ver:IPre+PL+P3:SPre+PL+P3
orienté	orienté	Adj:Mas+SG
oriente	orienter	Ver:IPre+SG+P1:IPre+SG+P3:SPre+SG+P1:SPre+SG+P3:ImPre+SG+P2
orienté	orienter	Ver:PPas+Mas+SG
orienteraient	orienter	Ver:CPre+PL+P3
orienterai	orienter	Ver:IFut+SG+P1
orienterais	orienter	Ver:CPre+SG+P1:CPre+SG+P2
orienterait	orienter	Ver:CPre+SG+P3
orientera	orienter	Ver:IFut+SG+P3
orienteras	orienter	Ver:IFut+SG+P2
orientèrent	orienter	Ver:IPSim+PL+P3
orienterez	orienter	Ver:IFut+PL+P2
orienteriez	orienter	Ver:CPre+PL+P2
orienterions	orienter	Ver:CPre+PL+P1
orienterons	orienter	Ver:IFut+PL+P1
orienteront	orienter	Ver:IFut+PL+P3
orienter	orienter	Ver:Inf
orientés	orienté	Adj:Mas+PL
orientes	orienter	Ver:IPre+SG+P2:SPre+SG+P2
orientés	orienter	Ver:PPas+Mas+PL
orienteur	orienteur	Adj:Mas+SG
orienteur	orienteur	Nom:Mas+SG
orienteurs	orienteur	Adj:Mas+PL
orienteurs	orienteur	Nom:Mas+PL
orientez	orienter	Ver:IPre+PL+P2:ImPre+PL+P2
orientiez	orienter	Ver:IImp+PL+P2:SPre+PL+P2
orientions	orienter	Ver:IImp+PL+P1:SPre+PL+P1
orientons	orienter	Ver:IPre+PL+P1:ImPre+PL+P1
orient	orient	Nom:Mas+SG
orients	orient	Nom:Mas+PL
orifice	orifice	Nom:Mas+SG
orifices	orifice	Nom:Mas+PL
oriflamme	oriflamme	Nom:Fem+SG
oriflammes	oriflamme	Nom:Fem+PL
origan	origan	Nom:Mas+SG
originairement	originairement	Adv
originaire	originaire	Adj:InvGen+SG
originaires	originaire	Adj:InvGen+PL
originalement	originalement	Adv
originale	original	Adj:Fem+SG
originale	original	Nom:Fem+SG
originales	original	Adj:Fem+PL
originales	original	Nom:Fem+PL
originalité	originalité	Nom:Fem+SG
originalités	originalité	Nom:Fem+PL
original	original	Adj:Mas+SG
originaux	original	Adj:Mas+PL
originaux	original	Nom:Mas+PL
originellement	originellement	Adv
originelle	originel	Adj:Fem+SG
originelles	originel	Adj:Fem+PL
originel	originel	Adj:Mas+SG
originels	originel	Adj:Mas+PL
origine	origine	Nom:Fem+SG
origine	originer	Ver:IPre+SG+P1:IPre+SG+P3:SPre+SG+P1:SPre+SG+P3:ImPre+SG+P2
origines	origine	Nom:Fem+PL
origines	originer	Ver:IPre+SG+P2:SPre+SG+P2
origines	origines	Nom:Fem+PL
orignal	orignal	Nom:Mas+SG
orignaux	orignal	Nom:Mas+PL
orillon	orillon	Nom:Mas+SG
orillons	orillon	Nom:Mas+PL
oringuer	oringuer	Ver:Inf
orin	orin	Nom:Mas+SG
orins	orin	Nom:Mas+PL
oripeau	oripeau	Nom:Mas+SG
oripeaux	oripeau	Nom:Mas+PL
oripeaux	oripeaux	Nom:Mas+PL
orléanais	orléanais	Adj:Mas+InvPL
orléanais	orléanais	Nom:Mas+InvPL
orléaniste	orléaniste	Adj:InvGen+SG
orléaniste	orléaniste	Nom:InvGen+SG
orle	orle	Nom:Mas+SG
orlon	orlon	Nom:Mas+SG
orlons	orlon	Nom:Mas+PL
ormaie	ormaie	Nom:Fem+SG
ormaies	ormaie	Nom:Fem+PL
ormeau	ormeau	Nom:Mas+SG
ormeaux	ormeau	Nom:Mas+PL
orme	orme	Nom:Mas+SG
ormes	orme	Nom:Mas+PL
ormille	ormille	Nom:Fem+SG
ormilles	ormille	Nom:Fem+PL
ormoie	ormoie	Nom:Fem+SG
ormoies	ormoie	Nom:Fem+PL
ornaient	orner	Ver:IImp+PL+P3
ornai	orner	Ver:IPSim+SG+P1
ornais	orner	Ver:IImp+SG+P1:IImp+SG+P2
ornait	orner	Ver:IImp+SG+P3
ornâmes	orner	Ver:IPSim+PL+P1
ornant	orner	Ver:PPre
orna	orner	Ver:IPSim+SG+P3
ornas	orner	Ver:IPSim+SG+P2
ornassent	orner	Ver:SImp+PL+P3
ornasse	orner	Ver:SImp+SG+P1
ornasses	orner	Ver:SImp+SG+P2
ornassiez	orner	Ver:SImp+PL+P2
ornassions	orner	Ver:SImp+PL+P1
ornâtes	orner	Ver:IPSim+PL+P2
ornât	orner	Ver:SImp+SG+P3
ornée	orner	Ver:PPas+Fem+SG
ornées	orner	Ver:PPas+Fem+PL
ornemaniste	ornemaniste	Adj:InvGen+SG
ornementaient	ornementer	Ver:IImp+PL+P3
ornementai	ornementer	Ver:IPSim+SG+P1
ornementais	ornementer	Ver:IImp+SG+P1:IImp+SG+P2
ornementait	ornementer	Ver:IImp+SG+P3
ornementale	ornemental	Adj:Fem+SG
ornementale	ornementale	Nom:Fem+SG
ornementales	ornemental	Adj:Fem+PL
ornementales	ornementale	Nom:Fem+PL
ornemental	ornemental	Adj:Mas+SG
ornementâmes	ornementer	Ver:IPSim+PL+P1
ornementant	ornementer	Ver:PPre
ornementa	ornementer	Ver:IPSim+SG+P3
ornementas	ornementer	Ver:IPSim+SG+P2
ornementassent	ornementer	Ver:SImp+PL+P3
ornementasse	ornementer	Ver:SImp+SG+P1
ornementasses	ornementer	Ver:SImp+SG+P2
ornementassiez	ornementer	Ver:SImp+PL+P2
ornementassions	ornementer	Ver:SImp+PL+P1
ornementâtes	ornementer	Ver:IPSim+PL+P2
ornementation	ornementation	Nom:Fem+SG
ornementations	ornementation	Nom:Fem+PL
ornementât	ornementer	Ver:SImp+SG+P3
ornementaux	ornemental	Adj:Mas+PL
ornementent	ornementer	Ver:IPre+PL+P3:SPre+PL+P3
ornemente	ornementer	Ver:IPre+SG+P1:IPre+SG+P3:SPre+SG+P1:SPre+SG+P3:ImPre+SG+P2
ornementé	ornementer	Ver:PPas+Mas+SG
ornementèrent	ornementer	Ver:IPSim+PL+P3
ornementer	ornementer	Ver:Inf
ornementes	ornementer	Ver:IPre+SG+P2:SPre+SG+P2
ornementez	ornementer	Ver:IPre+PL+P2:ImPre+PL+P2
ornementiez	ornementer	Ver:IImp+PL+P2:SPre+PL+P2
ornementions	ornementer	Ver:IImp+PL+P1:SPre+PL+P1
ornementons	ornementer	Ver:IPre+PL+P1:ImPre+PL+P1
ornement	ornement	Nom:Mas+SG
ornements	ornement	Nom:Mas+PL
ornent	orner	Ver:IPre+PL+P3:SPre+PL+P3
orne	orne	Nom:Mas+SG
orne	orner	Ver:IPre+SG+P1:IPre+SG+P3:SPre+SG+P1:SPre+SG+P3:ImPre+SG+P2
orné	orner	Ver:PPas+Mas+SG
orneraient	orner	Ver:CPre+PL+P3
ornerai	orner	Ver:IFut+SG+P1
ornerais	orner	Ver:CPre+SG+P1:CPre+SG+P2
ornerait	orner	Ver:CPre+SG+P3
ornera	orner	Ver:IFut+SG+P3
orneras	orner	Ver:IFut+SG+P2
ornèrent	orner	Ver:IPSim+PL+P3
ornerez	orner	Ver:IFut+PL+P2
orneriez	orner	Ver:CPre+PL+P2
ornerions	orner	Ver:CPre+PL+P1
ornerons	orner	Ver:IFut+PL+P1
orneront	orner	Ver:IFut+PL+P3
orner	orner	Ver:Inf
ornes	orne	Nom:Mas+PL
ornes	orner	Ver:IPre+SG+P2:SPre+SG+P2
ornés	orner	Ver:PPas+Mas+PL
ornez	orner	Ver:IPre+PL+P2:ImPre+PL+P2
ornière	ornière	Nom:Fem+SG
ornière	orniérer	Ver:IPre+SG+P1:IPre+SG+P3:SPre+SG+P1:SPre+SG+P3:ImPre+SG+P2
ornières	ornière	Nom:Fem+PL
ornières	orniérer	Ver:IPre+SG+P2:SPre+SG+P2
ornières	ornières	Nom:Fem+PL
orniez	orner	Ver:IImp+PL+P2:SPre+PL+P2
ornions	orner	Ver:IImp+PL+P1:SPre+PL+P1
ornithogale	ornithogale	Nom:Mas+SG
ornithogales	ornithogale	Nom:Mas+PL
ornithologie	ornithologie	Nom:Fem+SG
ornithologique	ornithologique	Adj:InvGen+SG
ornithologiste	ornithologiste	Nom:InvGen+SG
ornithologistes	ornithologiste	Nom:InvGen+PL
ornithologue	ornithologue	Nom:InvGen+SG
ornithologues	ornithologue	Nom:InvGen+PL
ornithomancie	ornithomancie	Nom:Fem+SG
ornithomancies	ornithomancie	Nom:Fem+PL
ornithorynque	ornithorynque	Nom:Mas+SG
ornithorynques	ornithorynque	Nom:Mas+PL
ornons	orner	Ver:IPre+PL+P1:ImPre+PL+P1
orobanche	orobanche	Nom:Fem+SG
orobanches	orobanche	Nom:Fem+PL
orobe	orobe	Nom:Mas+SG
orobes	orobe	Nom:Mas+PL
orogenèse	orogenèse	Nom:Fem+SG
orogenèses	orogenèse	Nom:Fem+PL
orogénie	orogénie	Nom:Fem+SG
orogénies	orogénie	Nom:Fem+PL
orogénique	orogénique	Adj:InvGen+SG
orogéniques	orogénique	Adj:InvGen+PL
orographie	orographie	Nom:Fem+SG
orographies	orographie	Nom:Fem+PL
orographique	orographique	Adj:InvGen+SG
oronge	oronge	Nom:Fem+SG
oronges	oronge	Nom:Fem+PL
oropharynx	oropharynx	Nom:Mas+InvPL
or	or	Con
or	or	Nom:Mas+SG
orpaillage	orpaillage	Nom:Mas+SG
orpaillages	orpaillage	Nom:Mas+PL
orpailleur	orpailleur	Nom:Mas+SG
orphelinage	orphelinage	Nom:Mas+SG
orphelinat	orphelinat	Nom:Mas+SG
orphelinats	orphelinat	Nom:Mas+PL
orpheline	orphelin	Adj:Fem+SG
orpheline	orphelin	Nom:Fem+SG
orphelines	orphelin	Adj:Fem+PL
orphelines	orphelines	Nom:Fem+PL
orphelines	orphelin	Nom:Fem+PL
orphelin	orphelin	Adj:Mas+SG
orphelin	orphelin	Nom:Mas+SG
orphelins	orphelin	Adj:Mas+PL
orphelins	orphelin	Nom:Mas+PL
orphéoniste	orphéoniste	Nom:InvGen+SG
orphéonistes	orphéoniste	Nom:InvGen+PL
orphéon	orphéon	Nom:Mas+SG
orphéons	orphéon	Nom:Mas+PL
orphie	orphie	Nom:Fem+SG
orphies	orphie	Nom:Fem+PL
orphique	orphique	Adj:InvGen+SG
orphisme	orphisme	Nom:Mas+SG
orpiment	orpiment	Nom:Mas+SG
orpin	orpin	Nom:Mas+SG
orque	orque	Nom:Fem+SG
orques	orque	Nom:Fem+PL
orseille	orseille	Nom:Fem+SG
orseilles	orseille	Nom:Fem+PL
ors	or	Nom:Mas+PL
orteil	orteil	Nom:Mas+SG
orteils	orteil	Nom:Mas+PL
orthocentre	orthocentre	Nom:Mas+SG
orthocentres	orthocentre	Nom:Mas+PL
orthochromatique	orthochromatique	Adj:InvGen+SG
orthodontie	orthodontie	Nom:Fem+SG
orthodonties	orthodontie	Nom:Fem+PL
orthodontiste	orthodontiste	Nom:InvGen+SG
orthodoxe	orthodoxe	Adj:InvGen+SG
orthodoxe	orthodoxe	Nom:InvGen+SG
orthodoxes	orthodoxe	Adj:InvGen+PL
orthodoxes	orthodoxe	Nom:InvGen+PL
orthodoxie	orthodoxie	Nom:Fem+SG
orthodoxies	orthodoxie	Nom:Fem+PL
orthogenèse	orthogenèse	Nom:Fem+SG
orthogenèses	orthogenèse	Nom:Fem+PL
orthogénie	orthogénie	Nom:Fem+SG
orthogonalement	orthogonalement	Adv
orthogonale	orthogonal	Adj:Fem+SG
orthogonales	orthogonal	Adj:Fem+PL
orthogonalité	orthogonalité	Nom:Fem+SG
orthogonalités	orthogonalité	Nom:Fem+PL
orthogonal	orthogonal	Adj:Mas+SG
orthogonaux	orthogonal	Adj:Mas+PL
orthographe	orthographe	Nom:Fem+SG
orthographes	orthographe	Nom:Fem+PL
orthographiaient	orthographier	Ver:IImp+PL+P3
orthographiai	orthographier	Ver:IPSim+SG+P1
orthographiais	orthographier	Ver:IImp+SG+P1:IImp+SG+P2
orthographiait	orthographier	Ver:IImp+SG+P3
orthographiâmes	orthographier	Ver:IPSim+PL+P1
orthographiant	orthographier	Ver:PPre
orthographiant	orthographier	Ver:PPre+Mas+SG
orthographia	orthographier	Ver:IPSim+SG+P3
orthographias	orthographier	Ver:IPSim+SG+P2
orthographiassent	orthographier	Ver:SImp+PL+P3
orthographiasse	orthographier	Ver:SImp+SG+P1
orthographiasses	orthographier	Ver:SImp+SG+P2
orthographiassiez	orthographier	Ver:SImp+PL+P2
orthographiassions	orthographier	Ver:SImp+PL+P1
orthographiâtes	orthographier	Ver:IPSim+PL+P2
orthographiât	orthographier	Ver:SImp+SG+P3
orthographiée	orthographier	Ver:PPas+Fem+SG
orthographiées	orthographier	Ver:PPas+Fem+PL
orthographient	orthographier	Ver:IPre+PL+P3:SPre+PL+P3
orthographie	orthographie	Nom:Fem+SG
orthographie	orthographier	Ver:IPre+SG+P1:IPre+SG+P3:SPre+SG+P1:SPre+SG+P3:ImPre+SG+P2
orthographié	orthographier	Ver:PPas+Mas+SG
orthographieraient	orthographier	Ver:CPre+PL+P3
orthographierai	orthographier	Ver:IFut+SG+P1
orthographierais	orthographier	Ver:CPre+SG+P1
orthographierais	orthographier	Ver:CPre+SG+P2
orthographierait	orthographier	Ver:CPre+SG+P3
orthographiera	orthographier	Ver:IFut+SG+P3
orthographieras	orthographier	Ver:IFut+SG+P2
orthographièrent	orthographier	Ver:IPSim+PL+P3
orthographierez	orthographier	Ver:IFut+PL+P2
orthographieriez	orthographier	Ver:CPre+PL+P2
orthographierions	orthographier	Ver:CPre+PL+P1
orthographierons	orthographier	Ver:IFut+PL+P1
orthographieront	orthographier	Ver:IFut+PL+P3
orthographier	orthographier	Ver:Inf
orthographies	orthographie	Nom:Fem+PL
orthographies	orthographier	Ver:IPre+SG+P2:SPre+SG+P2
orthographiés	orthographier	Ver:PPas+Mas+PL
orthographiez	orthographier	Ver:IPre+PL+P2:ImPre+PL+P2
orthographiiez	orthographier	Ver:IImp+PL+P2:SPre+PL+P2
orthographiions	orthographier	Ver:IImp+PL+P1:SPre+PL+P1
orthographions	orthographier	Ver:IPre+PL+P1:ImPre+PL+P1
orthographique	orthographique	Adj:InvGen+SG
orthographiques	orthographique	Adj:InvGen+PL
orthopédie	orthopédie	Nom:Fem+SG
orthopédique	orthopédique	Adj:InvGen+SG
orthopédiques	orthopédique	Adj:InvGen+PL
orthopédiste	orthopédiste	Nom:InvGen+SG
orthopédistes	orthopédiste	Nom:InvGen+PL
orthophonie	orthophonie	Nom:Fem+SG
orthophoniste	orthophoniste	Nom:InvGen+SG
orthophonistes	orthophoniste	Nom:InvGen+PL
orthoptères	orthoptère	Adj:InvGen+PL
orthoptères	orthoptère	Nom:Mas+PL
orthoptiste	orthoptiste	Nom:InvGen+SG
orthorhombique	orthorhombique	Adj:InvGen+SG
orthoscopie	orthoscopie	Nom:Fem+SG
orthoscopique	orthoscopique	Adj:InvGen+SG
orthose	orthose	Nom:Fem+SG
orthostate	orthostate	Nom:Mas+SG
orthostatique	orthostatique	Adj:InvGen+SG
orthostatisme	orthostatisme	Nom:Mas+SG
orthosympathique	orthosympathique	Adj:InvGen+SG
orthotrope	orthotrope	Adj:InvGen+SG
ortie	ortie	Nom:Fem+SG
ortie	ortier	Ver:IPre+SG+P1:IPre+SG+P3:SPre+SG+P1:SPre+SG+P3:ImPre+SG+P2
orties	ortie	Nom:Fem+PL
orties	ortier	Ver:IPre+SG+P2:SPre+SG+P2
ortive	ortive	Adj:Fem+SG
ortolan	ortolan	Nom:Mas+SG
ortolans	ortolan	Nom:Mas+PL
orvale	orvale	Nom:Fem+SG
orvet	orvet	Nom:Mas+SG
orvets	orvet	Nom:Mas+PL
orviétan	orviétan	Nom:Mas+SG
oryctérope	oryctérope	Nom:Mas+SG
oryx	oryx	Nom:Mas+InvPL
osaient	oser	Ver:IImp+PL+P3
osai	oser	Ver:IPSim+SG+P1
osais	oser	Ver:IImp+SG+P1:IImp+SG+P2
osait	oser	Ver:IImp+SG+P3
osâmes	oser	Ver:IPSim+PL+P1
osant	oser	Ver:PPre
osa	oser	Ver:IPSim+SG+P3
osas	oser	Ver:IPSim+SG+P2
osassent	oser	Ver:SImp+PL+P3
osasse	oser	Ver:SImp+SG+P1
osasses	oser	Ver:SImp+SG+P2
osassiez	oser	Ver:SImp+PL+P2
osassions	oser	Ver:SImp+PL+P1
osâtes	oser	Ver:IPSim+PL+P2
osât	oser	Ver:SImp+SG+P3
oscabrion	oscabrion	Nom:Mas+SG
oscar	oscar	Nom:Mas+SG
oscars	oscar	Nom:Mas+PL
oscillaient	osciller	Ver:IImp+PL+P3
oscillai	osciller	Ver:IPSim+SG+P1
oscillaire	oscillaire	Nom:Fem+SG
oscillais	osciller	Ver:IImp+SG+P1:IImp+SG+P2
oscillait	osciller	Ver:IImp+SG+P3
oscillâmes	osciller	Ver:IPSim+PL+P1
oscillante	oscillant	Adj:Fem+SG
oscillantes	oscillant	Adj:Fem+PL
oscillant	oscillant	Adj:Mas+SG
oscillant	osciller	Ver:PPre
oscillants	oscillant	Adj:Mas+PL
oscilla	osciller	Ver:IPSim+SG+P3
oscillas	osciller	Ver:IPSim+SG+P2
oscillassent	osciller	Ver:SImp+PL+P3
oscillasse	osciller	Ver:SImp+SG+P1
oscillasses	osciller	Ver:SImp+SG+P2
oscillassiez	osciller	Ver:SImp+PL+P2
oscillassions	osciller	Ver:SImp+PL+P1
oscillâtes	osciller	Ver:IPSim+PL+P2
oscillateur	oscillateur	Adj:Mas+SG
oscillateur	oscillateur	Nom:Mas+SG
oscillateurs	oscillateur	Adj:Mas+PL
oscillateurs	oscillateur	Nom:Mas+PL
oscillation	oscillation	Nom:Fem+SG
oscillations	oscillation	Nom:Fem+PL
oscillatoire	oscillatoire	Adj:InvGen+SG
oscillatoires	oscillatoire	Adj:InvGen+PL
oscillât	osciller	Ver:SImp+SG+P3
oscillent	osciller	Ver:IPre+PL+P3:SPre+PL+P3
oscille	osciller	Ver:IPre+SG+P1:IPre+SG+P3:SPre+SG+P1:SPre+SG+P3:ImPre+SG+P2
oscillé	osciller	Ver:PPas+Mas+SG
oscilleraient	osciller	Ver:CPre+PL+P3
oscillerai	osciller	Ver:IFut+SG+P1
oscillerais	osciller	Ver:CPre+SG+P1:CPre+SG+P2
oscillerait	osciller	Ver:CPre+SG+P3
oscillera	osciller	Ver:IFut+SG+P3
oscilleras	osciller	Ver:IFut+SG+P2
oscillèrent	osciller	Ver:IPSim+PL+P3
oscillerez	osciller	Ver:IFut+PL+P2
oscilleriez	osciller	Ver:CPre+PL+P2
oscillerions	osciller	Ver:CPre+PL+P1
oscillerons	osciller	Ver:IFut+PL+P1
oscilleront	osciller	Ver:IFut+PL+P3
osciller	osciller	Ver:Inf
oscilles	osciller	Ver:IPre+SG+P2:SPre+SG+P2
oscillez	osciller	Ver:IPre+PL+P2:ImPre+PL+P2
oscilliez	osciller	Ver:IImp+PL+P2:SPre+PL+P2
oscillions	osciller	Ver:IImp+PL+P1:SPre+PL+P1
oscillogramme	oscillogramme	Nom:Mas+SG
oscillographe	oscillographe	Nom:Mas+SG
oscillomètre	oscillomètre	Nom:Mas+SG
oscillométrie	oscillométrie	Nom:Fem+SG
oscillons	osciller	Ver:IPre+PL+P1:ImPre+PL+P1
oscilloscope	oscilloscope	Nom:Mas+SG
osculateur	osculateur	Adj:Mas+SG
osculation	osculation	Nom:Fem+SG
osculatrice	osculateur	Adj:Fem+SG
oscule	oscule	Nom:Mas+SG
osée	osé	Adj:Fem+SG
osées	osé	Adj:Fem+PL
oseille	oseille	Nom:Fem+SG
oseilles	oseille	Nom:Fem+PL
osent	oser	Ver:IPre+PL+P3:SPre+PL+P3
osé	osé	Adj:Mas+SG
ose	ose	Nom:Mas+SG
ose	oser	Ver:IPre+SG+P1:IPre+SG+P3:SPre+SG+P1:SPre+SG+P3:ImPre+SG+P2
osé	oser	Ver:PPas+Mas+SG
oseraient	oser	Ver:CPre+PL+P3
oseraie	oseraie	Nom:Fem+SG
oserai	oser	Ver:IFut+SG+P1
oserais	oser	Ver:CPre+SG+P1:CPre+SG+P2
oserait	oser	Ver:CPre+SG+P3
osera	oser	Ver:IFut+SG+P3
oseras	oser	Ver:IFut+SG+P2
osèrent	oser	Ver:IPSim+PL+P3
oserez	oser	Ver:IFut+PL+P2
oseriez	oser	Ver:CPre+PL+P2
oserions	oser	Ver:CPre+PL+P1
oserons	oser	Ver:IFut+PL+P1
oseront	oser	Ver:IFut+PL+P3
oser	oser	Ver:Inf
osés	osé	Adj:Mas+PL
oses	ose	Nom:Mas+PL
oses	oser	Ver:IPre+SG+P2:SPre+SG+P2
osez	oser	Ver:IPre+PL+P2:ImPre+PL+P2
oside	oside	Nom:Mas+SG
osiériculture	osiériculture	Nom:Fem+SG
osier	osier	Nom:Mas+SG
osiers	osier	Nom:Mas+PL
osiez	oser	Ver:IImp+PL+P2:SPre+PL+P2
osions	oser	Ver:IImp+PL+P1:SPre+PL+P1
osmique	osmique	Adj:InvGen+SG
osmiridium	osmiridium	Nom:Mas+SG
osmium	osmium	Nom:Mas+SG
osmiure	osmiure	Nom:Mas+SG
osmomètre	osmomètre	Nom:Mas+SG
osmométrie	osmométrie	Nom:Fem+SG
osmométrique	osmométrique	Adj:InvGen+SG
osmonde	osmonde	Nom:Fem+SG
osmose	osmose	Nom:Fem+SG
osmoses	osmose	Nom:Fem+PL
osmotique	osmotique	Adj:InvGen+SG
osons	oser	Ver:IPre+PL+P1:ImPre+PL+P1
os	os	Nom:Mas+InvPL
osque	osque	Adj:InvGen+SG
osque	osque	Nom:InvGen+SG
osque	osque	Nom:Mas+SG
osques	osque	Adj:InvGen+PL
osques	osque	Nom:InvGen+PL
osques	osque	Nom:Mas+PL
ossature	ossature	Nom:Fem+SG
ossatures	ossature	Nom:Fem+PL
osséine	osséine	Nom:Fem+SG
osselet	osselet	Nom:Mas+SG
osselets	osselet	Nom:Mas+PL
ossements	ossement	Nom:Mas+PL
ossète	ossète	Nom:Mas+SG
ossètes	ossète	Nom:Mas+PL
osseuse	osseux	Adj:Fem+SG
osseuses	osseux	Adj:Fem+PL
osseux	osseux	Adj:Mas+InvPL
ossianique	ossianique	Adj:InvGen+SG
ossianisme	ossianisme	Nom:Mas+SG
ossifiant	ossifier	Ver:PPre
ossification	ossification	Nom:Fem+SG
ossifiée	ossifier	Ver:PPas+Fem+SG
ossifiées	ossifier	Ver:PPas+Fem+PL
ossifié	ossifier	Ver:PPas+Mas+SG
ossifier	ossifier	Ver:Inf
ossifiés	ossifier	Ver:PPas+Mas+PL
ossifluent	ossifluent	Adj:Mas+SG
osso-bucco	osso-bucco	Nom:Mas+InvPL
ossuaire	ossuaire	Nom:Mas+SG
ossuaires	ossuaire	Nom:Mas+PL
ossue	ossu	Adj:Fem+SG
ossues	ossu	Adj:Fem+PL
ossu	ossu	Adj:Mas+SG
ossus	ossu	Adj:Mas+PL
ostéalgie	ostéalgie	Nom:Fem+SG
ostéalgique	ostéalgique	Adj:InvGen+SG
ostéite	ostéite	Nom:Fem+SG
ostensiblement	ostensiblement	Adv
ostensible	ostensible	Adj:InvGen+SG
ostensibles	ostensible	Adj:InvGen+PL
ostensif	ostensif	Adj:Mas+SG
ostensoir	ostensoir	Nom:Mas+SG
ostensoirs	ostensoir	Nom:Mas+PL
ostentation	ostentation	Nom:Fem+SG
ostentatoire	ostentatoire	Adj:InvGen+SG
ostentatoires	ostentatoire	Adj:InvGen+PL
ostentatrice	ostentateur	Adj:Fem+SG
ostéoblaste	ostéoblaste	Nom:Mas+SG
ostéochondrite	ostéochondrite	Nom:Fem+SG
ostéochondromatose	ostéochondromatose	Nom:Fem+SG
ostéochondrose	ostéochondrose	Nom:Fem+SG
ostéoclasie	ostéoclasie	Nom:Fem+SG
ostéoclaste	ostéoclaste	Nom:Mas+SG
ostéodynie	ostéodynie	Nom:Fem+SG
ostéogenèse	ostéogenèse	Nom:Fem+SG
ostéogénique	ostéogénique	Adj:InvGen+SG
ostéolithe	ostéolithe	Nom:Mas+SG
ostéologie	ostéologie	Nom:Fem+SG
ostéologique	ostéologique	Adj:InvGen+SG
ostéolyse	ostéolyse	Nom:Fem+SG
ostéomalacie	ostéomalacie	Nom:Fem+SG
ostéome	ostéome	Nom:Mas+SG
ostéomyélite	ostéomyélite	Nom:Fem+SG
ostéonécrose	ostéonécrose	Nom:Fem+SG
ostéopathe	ostéopathe	Nom:InvGen+SG
ostéopathie	ostéopathie	Nom:Fem+SG
ostéophone	ostéophone	Nom:Mas+SG
ostéophyte	ostéophyte	Nom:Mas+SG
ostéoplaste	ostéoplaste	Nom:Mas+SG
ostéoplastie	ostéoplastie	Nom:Fem+SG
ostéoporose	ostéoporose	Nom:Fem+SG
ostéosarcome	ostéosarcome	Nom:Mas+SG
ostéose	ostéose	Nom:Fem+SG
ostéosynthèse	ostéosynthèse	Nom:Fem+SG
ostéotomie	ostéotomie	Nom:Fem+SG
ostiak	ostiak	Adj:InvGen+SG
ostiak	ostiak	Nom:Mas+SG
ostinato	ostinato	Nom:Mas+SG
ostiole	ostiole	Nom:Mas+SG
ostique	ostique	Adj:InvGen+SG
osto	osto	Nom:Mas+SG
ost	ost	Nom:Mas+InvPL
ostraciser	ostraciser	Ver:Inf
ostracisme	ostracisme	Nom:Mas+SG
ostracismes	ostracisme	Nom:Mas+PL
ostracode	ostracode	Nom:Mas+SG
ostracon	ostracon	Nom:Mas+SG
ostréicole	ostréicole	Adj:InvGen+SG
ostréicoles	ostréicole	Adj:InvGen+PL
ostréiculteur	ostréiculteur	Nom:Mas+SG
ostréiculteurs	ostréiculteur	Nom:Mas+PL
ostréicultrice	ostréiculteur	Nom:Fem+SG
ostréicultrices	ostréiculteur	Nom:Fem+PL
ostréiculture	ostréiculture	Nom:Fem+SG
ostréidés	ostréidé	Nom:Mas+PL
ostrogote	ostrogot	Adj:Fem+SG
ostrogote	ostrogot	Nom:Fem+SG
ostrogothe	ostrogoth	Adj:Fem+SG
ostrogothe	ostrogoth	Nom:Fem+SG
ostrogothes	ostrogoth	Adj:Fem+PL
ostrogothes	ostrogoth	Nom:Fem+PL
ostrogoth	ostrogoth	Adj:Mas+SG
ostrogoth	ostrogoth	Nom:Mas+SG
ostrogoths	ostrogoth	Adj:Mas+PL
ostrogoths	ostrogoth	Nom:Mas+PL
ostrogot	ostrogot	Adj:Mas+SG
ostrogot	ostrogot	Nom:Mas+SG
ostyak	ostyak	Adj:InvGen+SG
otage	otage	Nom:Mas+SG
otages	otage	Nom:Mas+PL
ôtaient	ôter	Ver:IImp+PL+P3
ôtai	ôter	Ver:IPSim+SG+P1
ôtais	ôter	Ver:IImp+SG+P1:IImp+SG+P2
ôtait	ôter	Ver:IImp+SG+P3
otalgie	otalgie	Nom:Fem+SG
ôtâmes	ôter	Ver:IPSim+PL+P1
ôtant	ôter	Ver:PPre
ôta	ôter	Ver:IPSim+SG+P3
otarie	otarie	Nom:Fem+SG
otaries	otarie	Nom:Fem+PL
ôtas	ôter	Ver:IPSim+SG+P2
ôtassent	ôter	Ver:SImp+PL+P3
ôtasse	ôter	Ver:SImp+SG+P1
ôtasses	ôter	Ver:SImp+SG+P2
ôtassiez	ôter	Ver:SImp+PL+P2
ôtassions	ôter	Ver:SImp+PL+P1
ôtâtes	ôter	Ver:IPSim+PL+P2
ôtât	ôter	Ver:SImp+SG+P3
ôtée	ôté	Adj:Fem+SG
ôtées	ôté	Adj:Fem+PL
ôtent	ôter	Ver:IPre+PL+P3:SPre+PL+P3
ôté	ôté	Adj:Mas+SG
ôté	ôté	Pre
ôte	ôter	Ver:IPre+SG+P1:IPre+SG+P3:SPre+SG+P1:SPre+SG+P3:ImPre+SG+P2
ôté	ôter	Ver:PPas+Mas+SG
ôteraient	ôter	Ver:CPre+PL+P3
ôterai	ôter	Ver:IFut+SG+P1
ôterais	ôter	Ver:CPre+SG+P1:CPre+SG+P2
ôterait	ôter	Ver:CPre+SG+P3
ôtera	ôter	Ver:IFut+SG+P3
ôteras	ôter	Ver:IFut+SG+P2
ôtèrent	ôter	Ver:IPSim+PL+P3
ôterez	ôter	Ver:IFut+PL+P2
ôteriez	ôter	Ver:CPre+PL+P2
ôterions	ôter	Ver:CPre+PL+P1
ôterons	ôter	Ver:IFut+PL+P1
ôteront	ôter	Ver:IFut+PL+P3
ôter	ôter	Ver:Inf
ôtés	ôté	Adj:Mas+PL
ôtes	ôter	Ver:IPre+SG+P2:SPre+SG+P2
ôtés	ôter	Ver:PPas+Mas+PL
ôtez	ôter	Ver:IPre+PL+P2:ImPre+PL+P2
ôtiez	ôter	Ver:IImp+PL+P2:SPre+PL+P2
ôtions	ôter	Ver:IImp+PL+P1:SPre+PL+P1
otique	otique	Adj:InvGen+SG
otite	otite	Nom:Fem+SG
otites	otite	Nom:Fem+PL
otitique	otitique	Adj:InvGen+SG
otoconie	otoconie	Nom:Fem+SG
otocyon	otocyon	Nom:Mas+SG
otocyste	otocyste	Nom:Mas+SG
otolithe	otolithe	Nom:Fem+SG
otolithe	otolithe	Nom:Mas+SG
otologie	otologie	Nom:Fem+SG
otologique	otologique	Adj:InvGen+SG
otomi	otomi	Nom:Mas+SG
ôtons	ôter	Ver:IPre+PL+P1:ImPre+PL+P1
otoplastie	otoplastie	Nom:Fem+SG
otorragie	otorragie	Nom:Fem+SG
otorrhée	otorrhée	Nom:Fem+SG
otoscope	otoscope	Nom:Mas+SG
otospongiose	otospongiose	Nom:Fem+SG
oto-rhino	oto-rhino	Nom:Mas+SG
oto-rhinos	oto-rhino	Nom:Mas+PL
oto-rhino-laryngologie	oto-rhino-laryngologie	Nom:Fem+SG
oto-rhino-laryngologiste	oto-rhino-laryngologiste	Nom:InvGen+SG
oto-rhino-laryngologistes	oto-rhino-laryngologiste	Nom:InvGen+PL
ottomane	ottoman	Adj:Fem+SG
ottomane	ottomane	Nom:Fem+SG
ottomane	ottoman	Nom:Fem+SG
ottomanes	ottoman	Adj:Fem+PL
ottomanes	ottomane	Nom:Fem+PL
ottomanes	ottoman	Nom:Fem+PL
ottoman	ottoman	Adj:Mas+SG
ottomans	ottoman	Adj:Mas+PL
ottonien	ottonien	Adj:Mas+SG
ouabaïne	ouabaïne	Nom:Fem+SG
ouaille	ouaille	Nom:Fem+SG
ouailles	ouaille	Nom:Fem+PL
ouailles	ouailles	Nom:Fem+PL
ouais	ouais	Int
ouananiche	ouananiche	Nom:Fem+SG
ouaouaron	ouaouaron	Nom:Mas+SG
ouarine	ouarine	Nom:Mas+SG
ouataient	ouater	Ver:IImp+PL+P3
ouatai	ouater	Ver:IPSim+SG+P1
ouatais	ouater	Ver:IImp+SG+P1:IImp+SG+P2
ouatait	ouater	Ver:IImp+SG+P3
ouatâmes	ouater	Ver:IPSim+PL+P1
ouatant	ouater	Ver:PPre
ouata	ouater	Ver:IPSim+SG+P3
ouatas	ouater	Ver:IPSim+SG+P2
ouatassent	ouater	Ver:SImp+PL+P3
ouatasse	ouater	Ver:SImp+SG+P1
ouatasses	ouater	Ver:SImp+SG+P2
ouatassiez	ouater	Ver:SImp+PL+P2
ouatassions	ouater	Ver:SImp+PL+P1
ouatâtes	ouater	Ver:IPSim+PL+P2
ouatât	ouater	Ver:SImp+SG+P3
ouatée	ouaté	Adj:Fem+SG
ouatée	ouater	Ver:PPas+Fem+SG
ouatées	ouaté	Adj:Fem+PL
ouatées	ouater	Ver:PPas+Fem+PL
ouatent	ouater	Ver:IPre+PL+P3:SPre+PL+P3
ouaté	ouaté	Adj:Mas+SG
ouate	ouate	Nom:Fem+SG
ouate	ouater	Ver:IPre+SG+P1:IPre+SG+P3:SPre+SG+P1:SPre+SG+P3:ImPre+SG+P2
ouaté	ouater	Ver:PPas+Mas+SG
ouateraient	ouater	Ver:CPre+PL+P3
ouaterai	ouater	Ver:IFut+SG+P1
ouaterais	ouater	Ver:CPre+SG+P1:CPre+SG+P2
ouaterait	ouater	Ver:CPre+SG+P3
ouatera	ouater	Ver:IFut+SG+P3
ouateras	ouater	Ver:IFut+SG+P2
ouatèrent	ouater	Ver:IPSim+PL+P3
ouaterez	ouater	Ver:IFut+PL+P2
ouaterie	ouaterie	Nom:Fem+SG
ouateriez	ouater	Ver:CPre+PL+P2
ouaterions	ouater	Ver:CPre+PL+P1
ouaterons	ouater	Ver:IFut+PL+P1
ouateront	ouater	Ver:IFut+PL+P3
ouater	ouater	Ver:Inf
ouatés	ouaté	Adj:Mas+PL
ouates	ouate	Nom:Fem+PL
ouates	ouater	Ver:IPre+SG+P2:SPre+SG+P2
ouatés	ouater	Ver:PPas+Mas+PL
ouateux	ouateux	Adj:Mas+InvPL
ouatez	ouater	Ver:IPre+PL+P2:ImPre+PL+P2
ouatiez	ouater	Ver:IImp+PL+P2:SPre+PL+P2
ouatinaient	ouatiner	Ver:IImp+PL+P3
ouatinai	ouatiner	Ver:IPSim+SG+P1
ouatinais	ouatiner	Ver:IImp+SG+P1:IImp+SG+P2
ouatinait	ouatiner	Ver:IImp+SG+P3
ouatinâmes	ouatiner	Ver:IPSim+PL+P1
ouatinant	ouatiner	Ver:PPre
ouatina	ouatiner	Ver:IPSim+SG+P3
ouatinas	ouatiner	Ver:IPSim+SG+P2
ouatinassent	ouatiner	Ver:SImp+PL+P3
ouatinasse	ouatiner	Ver:SImp+SG+P1
ouatinasses	ouatiner	Ver:SImp+SG+P2
ouatinassiez	ouatiner	Ver:SImp+PL+P2
ouatinassions	ouatiner	Ver:SImp+PL+P1
ouatinâtes	ouatiner	Ver:IPSim+PL+P2
ouatinât	ouatiner	Ver:SImp+SG+P3
ouatinent	ouatiner	Ver:IPre+PL+P3:SPre+PL+P3
ouatine	ouatine	Nom:Fem+SG
ouatiné	ouatiner	Ver:PPas+Mas+SG
ouatineraient	ouatiner	Ver:CPre+PL+P3
ouatinerai	ouatiner	Ver:IFut+SG+P1
ouatinerais	ouatiner	Ver:CPre+SG+P1:CPre+SG+P2
ouatinerait	ouatiner	Ver:CPre+SG+P3
ouatinera	ouatiner	Ver:IFut+SG+P3
ouatineras	ouatiner	Ver:IFut+SG+P2
ouatinèrent	ouatiner	Ver:IPSim+PL+P3
ouatinerez	ouatiner	Ver:IFut+PL+P2
ouatineriez	ouatiner	Ver:CPre+PL+P2
ouatinerions	ouatiner	Ver:CPre+PL+P1
ouatinerons	ouatiner	Ver:IFut+PL+P1
ouatineront	ouatiner	Ver:IFut+PL+P3
ouatiner	ouatiner	Ver:Inf
ouatines	ouatine	Nom:Fem+PL
ouatinez	ouatiner	Ver:IPre+PL+P2:ImPre+PL+P2
ouatiniez	ouatiner	Ver:IImp+PL+P2:SPre+PL+P2
ouatinions	ouatiner	Ver:IImp+PL+P1:SPre+PL+P1
ouatinons	ouatiner	Ver:IPre+PL+P1:ImPre+PL+P1
ouations	ouater	Ver:IImp+PL+P1:SPre+PL+P1
ouatons	ouater	Ver:IPre+PL+P1:ImPre+PL+P1
oubliable	oubliable	Adj:InvGen+SG
oubliables	oubliable	Adj:InvGen+PL
oubliaient	oublier	Ver:IImp+PL+P3
oubliai	oublier	Ver:IPSim+SG+P1
oubliais	oublier	Ver:IImp+SG+P1:IImp+SG+P2
oubliait	oublier	Ver:IImp+SG+P3
oubliâmes	oublier	Ver:IPSim+PL+P1
oubliant	oublier	Ver:PPre
oublia	oublier	Ver:IPSim+SG+P3
oublias	oublier	Ver:IPSim+SG+P2
oubliassent	oublier	Ver:SImp+PL+P3
oubliasse	oublier	Ver:SImp+SG+P1
oubliasses	oublier	Ver:SImp+SG+P2
oubliassiez	oublier	Ver:SImp+PL+P2
oubliassions	oublier	Ver:SImp+PL+P1
oubliâtes	oublier	Ver:IPSim+PL+P2
oubliât	oublier	Ver:SImp+SG+P3
oubliée	oublier	Ver:PPas+Fem+SG
oubliées	oublier	Ver:PPas+Fem+PL
oublient	oublier	Ver:IPre+PL+P3:SPre+PL+P3
oublie	oublie	Nom:Fem+SG
oublié	oublier	Ver:PPas+Mas+SG
oublieraient	oublier	Ver:CPre+PL+P3
oublierai	oublier	Ver:IFut+SG+P1
oublierais	oublier	Ver:CPre+SG+P1:CPre+SG+P2
oublierait	oublier	Ver:CPre+SG+P3
oubliera	oublier	Ver:IFut+SG+P3
oublieras	oublier	Ver:IFut+SG+P2
oublièrent	oublier	Ver:IPSim+PL+P3
oublierez	oublier	Ver:IFut+PL+P2
oublieriez	oublier	Ver:CPre+PL+P2
oublierions	oublier	Ver:CPre+PL+P1
oublierons	oublier	Ver:IFut+PL+P1
oublieront	oublier	Ver:IFut+PL+P3
oublier	oublier	Ver:Inf
oublies	oublie	Nom:Fem+PL
oubliés	oublier	Ver:PPas+Mas+PL
oubliette	oubliette	Nom:Fem+SG
oubliettes	oubliette	Nom:Fem+PL
oublieuse	oublieux	Adj:Fem+SG
oublieuse	oublieux	Nom:Fem+SG
oublieuses	oublieux	Adj:Fem+PL
oublieuses	oublieux	Nom:Fem+PL
oublieux	oublieux	Adj:Mas+InvPL
oublieux	oublieux	Nom:Mas+InvPL
oubliez	oublier	Ver:IPre+PL+P2:ImPre+PL+P2
oubliiez	oublier	Ver:IImp+PL+P2:SPre+PL+P2
oubliions	oublier	Ver:IImp+PL+P1:SPre+PL+P1
oublions	oublier	Ver:IPre+PL+P1:ImPre+PL+P1
oubli	oubli	Nom:Mas+SG
oublis	oubli	Nom:Mas+PL
ouche	ouche	Nom:Fem+SG
oued	oued	Nom:Mas+SG
oueds	oued	Nom:Mas+PL
ouest	ouest	Adj:InvGen+SG:InvGen+PL
ouest	ouest	Nom:Mas+SG
ouest-allemand	ouest-allemand	Adj:Mas+SG
ouf	ouf	Int
ougaritique	ougaritique	Adj:InvGen+SG
ougrienne	ougrien	Adj:Fem+SG
ougriennes	ougrien	Adj:Fem+PL
ougrien	ougrien	Adj:Mas+SG
ougrien	ougrien	Nom:Mas+SG
ougriens	ougrien	Adj:Mas+PL
ougriens	ougrien	Nom:Mas+PL
ouguiya	ouguiya	Nom:Mas+SG
ouiche	ouiche	Int
ouïe	ouïe	Int
ouïe	ouïe	Nom:Fem+SG
ouïe	ouïr	Ver:PPas+Fem+SG
ouïes	ouïe	Nom:Fem+PL
ouïes	ouïes	Nom:Fem+PL
ouïes	ouïr	Ver:PPas+Fem+PL
ouïghour	ouïghour	Adj:InvGen+SG
ouïghour	ouïghour	Nom:InvGen+SG
ouïghour	ouïghour	Nom:Mas+SG
ouïgour	ouïgour	Adj:InvGen+SG
ouillage	ouillage	Nom:Mas+SG
ouillages	ouillage	Nom:Mas+PL
ouillaient	ouiller	Ver:IImp+PL+P3
ouillai	ouiller	Ver:IPSim+SG+P1
ouillais	ouiller	Ver:IImp+SG+P1:IImp+SG+P2
ouillait	ouiller	Ver:IImp+SG+P3
ouillâmes	ouiller	Ver:IPSim+PL+P1
ouillant	ouiller	Ver:PPre
ouilla	ouiller	Ver:IPSim+SG+P3
ouillas	ouiller	Ver:IPSim+SG+P2
ouillassent	ouiller	Ver:SImp+PL+P3
ouillasse	ouiller	Ver:SImp+SG+P1
ouillasses	ouiller	Ver:SImp+SG+P2
ouillassiez	ouiller	Ver:SImp+PL+P2
ouillassions	ouiller	Ver:SImp+PL+P1
ouillâtes	ouiller	Ver:IPSim+PL+P2
ouillât	ouiller	Ver:SImp+SG+P3
ouillée	ouiller	Ver:PPas+Fem+SG
ouillées	ouiller	Ver:PPas+Fem+PL
ouillent	ouiller	Ver:IPre+PL+P3:SPre+PL+P3
ouille	ouille	Int
ouille	ouiller	Ver:IPre+SG+P1:IPre+SG+P3:SPre+SG+P1:SPre+SG+P3:ImPre+SG+P2
ouillé	ouiller	Ver:PPas+Mas+SG
ouilleraient	ouiller	Ver:CPre+PL+P3
ouillerai	ouiller	Ver:IFut+SG+P1
ouillerais	ouiller	Ver:CPre+SG+P1:CPre+SG+P2
ouillerait	ouiller	Ver:CPre+SG+P3
ouillera	ouiller	Ver:IFut+SG+P3
ouilleras	ouiller	Ver:IFut+SG+P2
ouillèrent	ouiller	Ver:IPSim+PL+P3
ouillère	ouillère	Nom:Fem+SG
ouillerez	ouiller	Ver:IFut+PL+P2
ouilleriez	ouiller	Ver:CPre+PL+P2
ouillerions	ouiller	Ver:CPre+PL+P1
ouillerons	ouiller	Ver:IFut+PL+P1
ouilleront	ouiller	Ver:IFut+PL+P3
ouiller	ouiller	Ver:Inf
ouilles	ouiller	Ver:IPre+SG+P2:SPre+SG+P2
ouillés	ouiller	Ver:PPas+Mas+PL
ouillez	ouiller	Ver:IPre+PL+P2:ImPre+PL+P2
ouilliez	ouiller	Ver:IImp+PL+P2:SPre+PL+P2
ouillions	ouiller	Ver:IImp+PL+P1:SPre+PL+P1
ouillons	ouiller	Ver:IPre+PL+P1:ImPre+PL+P1
oui	oui	Adv
oui	oui	Nom:Mas+InvPL
ouï	ouïr	Ver:PPas+Mas+SG
ouïr	ouïr	Ver:Inf
ouïs	ouïr	Ver:PPas+Mas+PL:IPre+SG+P1:IPre+SG+P2:IPSim+SG+P1:IPSim+SG+P2:ImPre+SG+P2
ouistiti	ouistiti	Nom:Mas+SG
ouistitis	ouistiti	Nom:Mas+PL
ouït	ouïr	Ver:IPSim+SG+P3
ouï-dire	ouï-dire	Nom:Mas+InvPL
oukase	oukase	Nom:Mas+SG
oukases	oukase	Nom:Mas+PL
ouléma	ouléma	Nom:Mas+SG
oulémas	ouléma	Nom:Mas+PL
oulice	oulice	Nom:Fem+SG
oumiak	oumiak	Nom:Mas+SG
ou	ou	Con
où	où	Pro
ouragan	ouragan	Nom:Mas+SG
ouragans	ouragan	Nom:Mas+PL
ouralienne	ouralien	Adj:Fem+SG
ouraliennes	ouralien	Adj:Fem+PL
ouralien	ouralien	Adj:Mas+SG
ourdie	ourdir	Ver:PPas+Fem+SG
ourdies	ourdir	Ver:PPas+Fem+PL
ourdîmes	ourdir	Ver:IPSim+PL+P1
ourdi	ourdir	Ver:PPas+Mas+SG
ourdiraient	ourdir	Ver:CPre+PL+P3
ourdirai	ourdir	Ver:IFut+SG+P1
ourdirais	ourdir	Ver:CPre+SG+P1:CPre+SG+P2
ourdirait	ourdir	Ver:CPre+SG+P3
ourdira	ourdir	Ver:IFut+SG+P3
ourdiras	ourdir	Ver:IFut+SG+P2
ourdirent	ourdir	Ver:IPSim+PL+P3
ourdirez	ourdir	Ver:IFut+PL+P2
ourdiriez	ourdir	Ver:CPre+PL+P2
ourdirions	ourdir	Ver:CPre+PL+P1
ourdirons	ourdir	Ver:IFut+PL+P1
ourdiront	ourdir	Ver:IFut+PL+P3
ourdir	ourdir	Ver:Inf
ourdis	ourdir	Ver:PPas+Mas+PL:IPre+SG+P1:IPre+SG+P2:IPSim+SG+P1:IPSim+SG+P2:ImPre+SG+P2
ourdissage	ourdissage	Nom:Mas+SG
ourdissages	ourdissage	Nom:Mas+PL
ourdissaient	ourdir	Ver:IImp+PL+P3
ourdissais	ourdir	Ver:IImp+SG+P1:IImp+SG+P2
ourdissait	ourdir	Ver:IImp+SG+P3
ourdissant	ourdir	Ver:PPre
ourdissant	ourdir	Ver:PPre
ourdissant	ourdir	Ver:PPre+Mas+SG
ourdissent	ourdir	Ver:IPre+PL+P3:SPre+PL+P3:SImp+PL+P3
ourdisse	ourdir	Ver:SPre+SG+P1:SPre+SG+P3:SImp+SG+P1
ourdisses	ourdir	Ver:SPre+SG+P2:SImp+SG+P2
ourdisseur	ourdisseur	Nom:Mas+SG
ourdisseuse	ourdisseur	Nom:Fem+SG
ourdissez	ourdir	Ver:IPre+PL+P2:ImPre+PL+P2
ourdissiez	ourdir	Ver:IImp+PL+P2:SPre+PL+P2:SImp+PL+P2
ourdissions	ourdir	Ver:IImp+PL+P1:SPre+PL+P1:SImp+PL+P1
ourdissoir	ourdissoir	Nom:Mas+SG
ourdissons	ourdir	Ver:IPre+PL+P1:ImPre+PL+P1
ourdîtes	ourdir	Ver:IPSim+PL+P2
ourdit	ourdir	Ver:IPre+SG+P3:IPSim+SG+P3
ourdît	ourdir	Ver:SImp+SG+P3
ourdou	ourdou	Adj:InvGen+SG:InvGen+PL
ourdou	ourdou	Nom:Mas+SG
ourdous	ourdou	Nom:Mas+PL
ourlaient	ourler	Ver:IImp+PL+P3
ourlai	ourler	Ver:IPSim+SG+P1
ourlais	ourler	Ver:IImp+SG+P1:IImp+SG+P2
ourlait	ourler	Ver:IImp+SG+P3
ourlâmes	ourler	Ver:IPSim+PL+P1
ourlant	ourler	Ver:PPre
ourla	ourler	Ver:IPSim+SG+P3
ourlas	ourler	Ver:IPSim+SG+P2
ourlassent	ourler	Ver:SImp+PL+P3
ourlasse	ourler	Ver:SImp+SG+P1
ourlasses	ourler	Ver:SImp+SG+P2
ourlassiez	ourler	Ver:SImp+PL+P2
ourlassions	ourler	Ver:SImp+PL+P1
ourlâtes	ourler	Ver:IPSim+PL+P2
ourlât	ourler	Ver:SImp+SG+P3
ourlée	ourlé	Adj:Fem+SG
ourlée	ourler	Ver:PPas+Fem+SG
ourlées	ourlé	Adj:Fem+PL
ourlées	ourler	Ver:PPas+Fem+PL
ourlent	ourler	Ver:IPre+PL+P3:SPre+PL+P3
ourlé	ourlé	Adj:Mas+SG
ourle	ourler	Ver:IPre+SG+P1:IPre+SG+P3:SPre+SG+P1:SPre+SG+P3:ImPre+SG+P2
ourlé	ourler	Ver:PPas+Mas+SG
ourlèrent	ourler	Ver:IPSim+PL+P3
ourler	ourler	Ver:Inf
ourlés	ourlé	Adj:Mas+PL
ourles	ourler	Ver:IPre+SG+P2:SPre+SG+P2
ourlés	ourler	Ver:PPas+Mas+PL
ourles	ourles	Nom:Mas+PL
ourlet	ourlet	Nom:Mas+SG
ourlets	ourlet	Nom:Mas+PL
ourlez	ourler	Ver:IPre+PL+P2:ImPre+PL+P2
ourlienne	ourlien	Adj:Fem+SG
ourliennes	ourlien	Adj:Fem+PL
ourlien	ourlien	Adj:Mas+SG
ourliez	ourler	Ver:IImp+PL+P2:SPre+PL+P2
ourlions	ourler	Ver:IImp+PL+P1:SPre+PL+P1
ourlons	ourler	Ver:IPre+PL+P1:ImPre+PL+P1
ourse	ourse	Nom:Fem+SG
ourse	ours	Nom:Fem+SG
ourses	ourse	Nom:Fem+PL
ourses	ours	Nom:Fem+PL
oursin	oursin	Nom:Mas+SG
oursins	oursin	Nom:Mas+PL
ourson	ourson	Nom:Mas+SG
oursons	ourson	Nom:Mas+PL
ours	ours	Adj:InvGen+SG:InvGen+PL
ours	ours	Nom:Mas+InvPL
ouste	ouste	Int
oust	oust	Int
outang	outang	Nom:Mas+SG
outangs	outang	Nom:Mas+PL
outan	outan	Nom:Mas+SG
outans	outan	Nom:Mas+PL
outant	outer	Ver:PPre
outardeau	outardeau	Nom:Mas+SG
outardeaux	outardeau	Nom:Mas+PL
outarde	outarde	Nom:Fem+SG
outardes	outarde	Nom:Fem+PL
outée	outer	Ver:PPas+Fem+SG
outées	outer	Ver:PPas+Fem+PL
outé	outer	Ver:PPas+Mas+SG
outer	outer	Ver:Inf
outés	outer	Ver:PPas+Mas+PL
outillage	outillage	Nom:Mas+SG
outillages	outillage	Nom:Mas+PL
outillant	outiller	Ver:PPre
outillée	outillé	Adj:Fem+SG
outillée	outiller	Ver:PPas+Fem+SG
outillées	outillé	Adj:Fem+PL
outillées	outiller	Ver:PPas+Fem+PL
outillé	outillé	Adj:Mas+SG
outillé	outiller	Ver:PPas+Mas+SG
outiller	outiller	Ver:Inf
outillés	outillé	Adj:Mas+PL
outillés	outiller	Ver:PPas+Mas+PL
outilleur	outilleur	Nom:Mas+SG
outilleurs	outilleur	Nom:Mas+PL
outil	outil	Nom:Mas+SG
outils	outil	Nom:Mas+PL
outlaw	outlaw	Nom:Mas+SG
out	out	Adv
output	output	Nom:Mas+SG
outrageaient	outrager	Ver:IImp+PL+P3
outrageai	outrager	Ver:IPSim+SG+P1
outrageais	outrager	Ver:IImp+SG+P1:IImp+SG+P2
outrageait	outrager	Ver:IImp+SG+P3
outrageâmes	outrager	Ver:IPSim+PL+P1
outrageante	outrageant	Adj:Fem+SG
outrageantes	outrageant	Adj:Fem+PL
outrageant	outrageant	Adj:Mas+SG
outrageant	outrager	Ver:PPre
outrageants	outrageant	Adj:Mas+PL
outragea	outrager	Ver:IPSim+SG+P3
outrageas	outrager	Ver:IPSim+SG+P2
outrageassent	outrager	Ver:SImp+PL+P3
outrageasse	outrager	Ver:SImp+SG+P1
outrageasses	outrager	Ver:SImp+SG+P2
outrageassiez	outrager	Ver:SImp+PL+P2
outrageassions	outrager	Ver:SImp+PL+P1
outrageâtes	outrager	Ver:IPSim+PL+P2
outrageât	outrager	Ver:SImp+SG+P3
outragée	outragé	Adj:Fem+SG
outragées	outragé	Adj:Fem+PL
outragent	outrager	Ver:IPre+PL+P3:SPre+PL+P3
outrageons	outrager	Ver:IPre+PL+P1:ImPre+PL+P1
outragé	outragé	Adj:Mas+SG
outrage	outrage	Nom:Mas+SG
outrage	outrager	Ver:IPre+SG+P1:IPre+SG+P3:SPre+SG+P1:SPre+SG+P3:ImPre+SG+P2
outrageraient	outrager	Ver:CPre+PL+P3
outragerai	outrager	Ver:IFut+SG+P1
outragerais	outrager	Ver:CPre+SG+P1:CPre+SG+P2
outragerait	outrager	Ver:CPre+SG+P3
outragera	outrager	Ver:IFut+SG+P3
outrageras	outrager	Ver:IFut+SG+P2
outragèrent	outrager	Ver:IPSim+PL+P3
outragerez	outrager	Ver:IFut+PL+P2
outrageriez	outrager	Ver:CPre+PL+P2
outragerions	outrager	Ver:CPre+PL+P1
outragerons	outrager	Ver:IFut+PL+P1
outrageront	outrager	Ver:IFut+PL+P3
outrager	outrager	Ver:Inf
outragés	outragé	Adj:Mas+PL
outrages	outrage	Nom:Mas+PL
outrages	outrager	Ver:IPre+SG+P2:SPre+SG+P2
outrageusement	outrageusement	Adv
outrageuse	outrageux	Adj:Fem+SG
outrageuses	outrageux	Adj:Fem+PL
outrageux	outrageux	Adj:Mas+InvPL
outragez	outrager	Ver:IPre+PL+P2:ImPre+PL+P2
outragiez	outrager	Ver:IImp+PL+P2:SPre+PL+P2
outragions	outrager	Ver:IImp+PL+P1:SPre+PL+P1
outraient	outrer	Ver:IImp+PL+P3
outrai	outrer	Ver:IPSim+SG+P1
outrais	outrer	Ver:IImp+SG+P1:IImp+SG+P2
outrait	outrer	Ver:IImp+SG+P3
outrâmes	outrer	Ver:IPSim+PL+P1
outrance	outrance	Nom:Fem+SG
outrances	outrance	Nom:Fem+PL
outrancière	outrancier	Adj:Fem+SG
outrancières	outrancier	Adj:Fem+PL
outrancier	outrancier	Adj:Mas+SG
outranciers	outrancier	Adj:Mas+PL
outrant	outrer	Ver:PPre
outra	outrer	Ver:IPSim+SG+P3
outras	outrer	Ver:IPSim+SG+P2
outrassent	outrer	Ver:SImp+PL+P3
outrasse	outrer	Ver:SImp+SG+P1
outrasses	outrer	Ver:SImp+SG+P2
outrassiez	outrer	Ver:SImp+PL+P2
outrassions	outrer	Ver:SImp+PL+P1
outrâtes	outrer	Ver:IPSim+PL+P2
outrât	outrer	Ver:SImp+SG+P3
outrecuidance	outrecuidance	Nom:Fem+SG
outrecuidante	outrecuidant	Adj:Fem+SG
outrecuidantes	outrecuidant	Adj:Fem+PL
outrecuidant	outrecuidant	Adj:Mas+SG
outrecuidant	outrecuider	Ver:PPre
outrecuidants	outrecuidant	Adj:Mas+PL
outrée	outré	Adj:Fem+SG
outrées	outré	Adj:Fem+PL
outremer	outremer	Adj:InvGen+SG:InvGen+PL
outremer	outremer	Nom:Mas+SG
outrent	outrer	Ver:IPre+PL+P3:SPre+PL+P3
outré	outré	Adj:Mas+SG
outre	outre	Adv
outre	outre	Nom:Fem+SG
outre	outre	Pre
outre	outrer	Ver:IPre+SG+P1:IPre+SG+P3:SPre+SG+P1:SPre+SG+P3:ImPre+SG+P2
outrepassaient	outrepasser	Ver:IImp+PL+P3
outrepassai	outrepasser	Ver:IPSim+SG+P1
outrepassais	outrepasser	Ver:IImp+SG+P1:IImp+SG+P2
outrepassait	outrepasser	Ver:IImp+SG+P3
outrepassâmes	outrepasser	Ver:IPSim+PL+P1
outrepassant	outrepasser	Ver:PPre
outrepassa	outrepasser	Ver:IPSim+SG+P3
outrepassas	outrepasser	Ver:IPSim+SG+P2
outrepassassent	outrepasser	Ver:SImp+PL+P3
outrepassasse	outrepasser	Ver:SImp+SG+P1
outrepassasses	outrepasser	Ver:SImp+SG+P2
outrepassassiez	outrepasser	Ver:SImp+PL+P2
outrepassassions	outrepasser	Ver:SImp+PL+P1
outrepassâtes	outrepasser	Ver:IPSim+PL+P2
outrepassât	outrepasser	Ver:SImp+SG+P3
outrepassée	outrepassé	Adj:Fem+SG
outrepassées	outrepassé	Adj:Fem+PL
outrepassent	outrepasser	Ver:IPre+PL+P3:SPre+PL+P3
outrepassé	outrepassé	Adj:Mas+SG
outrepasse	outrepasse	Nom:Fem+SG
outrepasse	outrepasser	Ver:IPre+SG+P1:IPre+SG+P3:SPre+SG+P1:SPre+SG+P3:ImPre+SG+P2
outrepassé	outrepasser	Ver:PPas+Mas+SG
outrepasseraient	outrepasser	Ver:CPre+PL+P3
outrepasserai	outrepasser	Ver:IFut+SG+P1
outrepasserais	outrepasser	Ver:CPre+SG+P1:CPre+SG+P2
outrepasserait	outrepasser	Ver:CPre+SG+P3
outrepassera	outrepasser	Ver:IFut+SG+P3
outrepasseras	outrepasser	Ver:IFut+SG+P2
outrepassèrent	outrepasser	Ver:IPSim+PL+P3
outrepasserez	outrepasser	Ver:IFut+PL+P2
outrepasseriez	outrepasser	Ver:CPre+PL+P2
outrepasserions	outrepasser	Ver:CPre+PL+P1
outrepasserons	outrepasser	Ver:IFut+PL+P1
outrepasseront	outrepasser	Ver:IFut+PL+P3
outrepasser	outrepasser	Ver:Inf
outrepassés	outrepassé	Adj:Mas+PL
outrepasses	outrepasser	Ver:IPre+SG+P2:SPre+SG+P2
outrepassez	outrepasser	Ver:IPre+PL+P2:ImPre+PL+P2
outrepassiez	outrepasser	Ver:IImp+PL+P2
outrepassiez	outrepasser	Ver:SPre+PL+P2
outrepassions	outrepasser	Ver:IImp+PL+P1
outrepassions	outrepasser	Ver:SPre+PL+P1
outrepassons	outrepasser	Ver:IPre+PL+P1:ImPre+PL+P1
outreraient	outrer	Ver:CPre+PL+P3
outrerai	outrer	Ver:IFut+SG+P1
outrerais	outrer	Ver:CPre+SG+P1:CPre+SG+P2
outrerait	outrer	Ver:CPre+SG+P3
outrera	outrer	Ver:IFut+SG+P3
outreras	outrer	Ver:IFut+SG+P2
outrèrent	outrer	Ver:IPSim+PL+P3
outrerez	outrer	Ver:IFut+PL+P2
outreriez	outrer	Ver:CPre+PL+P2
outrerions	outrer	Ver:CPre+PL+P1
outrerons	outrer	Ver:IFut+PL+P1
outreront	outrer	Ver:IFut+PL+P3
outrer	outrer	Ver:Inf
outrés	outré	Adj:Mas+PL
outres	outre	Nom:Fem+PL
outres	outrer	Ver:IPre+SG+P2:SPre+SG+P2
outrez	outrer	Ver:IPre+PL+P2:ImPre+PL+P2
outre-mer	outre-mer	Adv
outriez	outrer	Ver:IImp+PL+P2:SPre+PL+P2
outrions	outrer	Ver:IImp+PL+P1:SPre+PL+P1
outrons	outrer	Ver:IPre+PL+P1:ImPre+PL+P1
outsider	outsider	Nom:InvGen+SG
outsider	outsider	Nom:Mas+SG
outsiders	outsider	Nom:InvGen+PL
outsiders	outsider	Nom:Mas+PL
ouvala	ouvala	Nom:Fem+SG
ouvertement	ouvertement	Adv
ouverte	ouvert	Adj:Fem+SG
ouverte	ouvrir	Ver:PPas+Fem+SG
ouvertes	ouvert	Adj:Fem+PL
ouvertes	ouvrir	Ver:PPas+Fem+PL
ouvert	ouvert	Adj:Mas+SG
ouvert	ouvert	Nom:Mas+SG
ouvert	ouvrir	Ver:PPas+Mas+SG
ouverts	ouvert	Adj:Mas+PL
ouverts	ouvert	Nom:Mas+PL
ouverts	ouvrir	Ver:PPas+Mas+PL
ouverture	ouverture	Nom:Fem+SG
ouvertures	ouverture	Nom:Fem+PL
ouvertures	ouvertures	Nom:Fem+PL
ouvrabilité	ouvrabilité	Nom:Fem+SG
ouvrable	ouvrable	Adj:InvGen+SG
ouvrables	ouvrable	Adj:InvGen+PL
ouvrageant	ouvrager	Ver:PPre
ouvragée	ouvragé	Adj:Fem+SG
ouvragée	ouvrager	Ver:PPas+Fem+SG
ouvragées	ouvragé	Adj:Fem+PL
ouvragées	ouvrager	Ver:PPas+Fem+PL
ouvragent	ouvrager	Ver:IPre+PL+P3:SPre+PL+P3
ouvragé	ouvragé	Adj:Mas+SG
ouvrage	ouvrage	Nom:Mas+SG
ouvrage	ouvrager	Ver:IPre+SG+P1:IPre+SG+P3:SPre+SG+P1:SPre+SG+P3:ImPre+SG+P2
ouvrager	ouvrager	Ver:Inf
ouvragés	ouvragé	Adj:Mas+PL
ouvrages	ouvrage	Nom:Mas+PL
ouvrages	ouvrager	Ver:IPre+SG+P2:SPre+SG+P2
ouvragés	ouvrager	Ver:PPas+Mas+PL
ouvraient	ouvrer	Ver:IImp+PL+P3
ouvraient	ouvrir	Ver:IImp+PL+P3
ouvrai	ouvrer	Ver:IPSim+SG+P1
ouvraison	ouvraison	Nom:Fem+SG
ouvrais	ouvrer	Ver:IImp+SG+P1:IImp+SG+P2
ouvrais	ouvrir	Ver:IImp+SG+P1:IImp+SG+P2
ouvrait	ouvrer	Ver:IImp+SG+P3
ouvrait	ouvrir	Ver:IImp+SG+P3
ouvrâmes	ouvrer	Ver:IPSim+PL+P1
ouvrante	ouvrant	Adj:Fem+SG
ouvrantes	ouvrant	Adj:Fem+PL
ouvrant	ouvrant	Adj:Mas+SG
ouvrant	ouvrant	Nom:Mas+SG
ouvrant	ouvrer	Ver:PPre
ouvrant	ouvrir	Ver:PPre
ouvrants	ouvrant	Adj:Mas+PL
ouvrants	ouvrant	Nom:Mas+PL
ouvrants	ouvrants	Nom:Mas+PL
ouvra	ouvrer	Ver:IPSim+SG+P3
ouvras	ouvrer	Ver:IPSim+SG+P2
ouvrassent	ouvrer	Ver:SImp+PL+P3
ouvrasse	ouvrer	Ver:SImp+SG+P1
ouvrasses	ouvrer	Ver:SImp+SG+P2
ouvrassiez	ouvrer	Ver:SImp+PL+P2
ouvrassions	ouvrer	Ver:SImp+PL+P1
ouvrâtes	ouvrer	Ver:IPSim+PL+P2
ouvrât	ouvrer	Ver:SImp+SG+P3
ouvreau	ouvreau	Nom:Mas+SG
ouvreaux	ouvreau	Nom:Mas+PL
ouvrée	ouvré	Adj:Fem+SG
ouvrées	ouvré	Adj:Fem+PL
ouvrent	ouvrer	Ver:IPre+PL+P3:SPre+PL+P3
ouvrent	ouvrir	Ver:IPre+PL+P3:SPre+PL+P3
ouvré	ouvré	Adj:Mas+SG
ouvre	ouvrer	Ver:IPre+SG+P1:IPre+SG+P3:SPre+SG+P1:SPre+SG+P3:ImPre+SG+P2
ouvré	ouvrer	Ver:PPas+Mas+SG
ouvre	ouvrir	Ver:IPre+SG+P1:IPre+SG+P3:SPre+SG+P1:SPre+SG+P3:ImPre+SG+P2
ouvreraient	ouvrer	Ver:CPre+PL+P3
ouvrerai	ouvrer	Ver:IFut+SG+P1
ouvrerais	ouvrer	Ver:CPre+SG+P1:CPre+SG+P2
ouvrerait	ouvrer	Ver:CPre+SG+P3
ouvrera	ouvrer	Ver:IFut+SG+P3
ouvreras	ouvrer	Ver:IFut+SG+P2
ouvrèrent	ouvrer	Ver:IPSim+PL+P3
ouvrerez	ouvrer	Ver:IFut+PL+P2
ouvreriez	ouvrer	Ver:CPre+PL+P2
ouvrerions	ouvrer	Ver:CPre+PL+P1
ouvrerons	ouvrer	Ver:IFut+PL+P1
ouvreront	ouvrer	Ver:IFut+PL+P3
ouvrer	ouvrer	Ver:Inf
ouvrés	ouvré	Adj:Mas+PL
ouvres	ouvrer	Ver:IPre+SG+P2:SPre+SG+P2
ouvres	ouvrir	Ver:IPre+SG+P2:SPre+SG+P2
ouvreur	ouvreur	Nom:Mas+SG
ouvreurs	ouvreur	Nom:Mas+PL
ouvreuse	ouvreur	Nom:Fem+SG
ouvreuse	ouvreuse	Nom:Fem+SG
ouvreuses	ouvreur	Nom:Fem+PL
ouvreuses	ouvreuse	Nom:Fem+PL
ouvrez	ouvrer	Ver:IPre+PL+P2:ImPre+PL+P2
ouvrez	ouvrir	Ver:IPre+PL+P2:ImPre+PL+P2
ouvre-boîte	ouvre-boîte	Nom:Mas+SG
ouvre-boîtes	ouvre-boîte	Nom:Mas+PL
ouvre-boîtes	ouvre-boîtes	Nom:Mas+InvPL
ouvre-bouteille	ouvre-bouteille	Nom:Mas+SG
ouvre-bouteilles	ouvre-bouteille	Nom:Mas+PL
ouvre-bouteilles	ouvre-bouteilles	Nom:Mas+InvPL
ouvre-gant	ouvre-gant	Nom:Mas+SG
ouvre-gants	ouvre-gant	Nom:Mas+PL
ouvre-gants	ouvre-gants	Nom:Mas+InvPL
ouvre-huître	ouvre-huître	Nom:Mas+SG
ouvre-huîtres	ouvre-huître	Nom:Mas+PL
ouvre-huîtres	ouvre-huîtres	Nom:Mas+InvPL
ouvrière	ouvrier	Adj:Fem+SG
ouvrière	ouvrière	Nom:Fem+SG
ouvrière	ouvrier	Nom:Fem+SG
ouvrières	ouvrier	Adj:Fem+PL
ouvrières	ouvrière	Nom:Fem+PL
ouvrières	ouvrier	Nom:Fem+PL
ouvriérisme	ouvriérisme	Nom:Mas+SG
ouvriériste	ouvriériste	Adj:InvGen+SG
ouvriériste	ouvriériste	Nom:InvGen+SG
ouvrier	ouvrier	Adj:Mas+SG
ouvrier	ouvrier	Nom:Mas+SG
ouvriers	ouvrier	Adj:Mas+PL
ouvriers	ouvrier	Nom:Mas+PL
ouvriez	ouvrer	Ver:IImp+PL+P2:SPre+PL+P2
ouvriez	ouvrir	Ver:IImp+PL+P2:SPre+PL+P2
ouvrîmes	ouvrir	Ver:IPSim+PL+P1
ouvrions	ouvrer	Ver:IImp+PL+P1:SPre+PL+P1
ouvrions	ouvrir	Ver:IImp+PL+P1:SPre+PL+P1
ouvriraient	ouvrir	Ver:CPre+PL+P3
ouvrirai	ouvrir	Ver:IFut+SG+P1
ouvrirais	ouvrir	Ver:CPre+SG+P1:CPre+SG+P2
ouvrirait	ouvrir	Ver:CPre+SG+P3
ouvrira	ouvrir	Ver:IFut+SG+P3
ouvriras	ouvrir	Ver:IFut+SG+P2
ouvrirent	ouvrir	Ver:IPSim+PL+P3
ouvrirez	ouvrir	Ver:IFut+PL+P2
ouvririez	ouvrir	Ver:CPre+PL+P2
ouvririons	ouvrir	Ver:CPre+PL+P1
ouvrirons	ouvrir	Ver:IFut+PL+P1
ouvriront	ouvrir	Ver:IFut+PL+P3
ouvrir	ouvrir	Ver:Inf
ouvris	ouvrir	Ver:IPSim+SG+P1:IPSim+SG+P2
ouvrissent	ouvrir	Ver:SImp+PL+P3
ouvrisse	ouvrir	Ver:SImp+SG+P1
ouvrisses	ouvrir	Ver:SImp+SG+P2
ouvrissiez	ouvrir	Ver:SImp+PL+P2
ouvrissions	ouvrir	Ver:SImp+PL+P1
ouvrîtes	ouvrir	Ver:IPSim+PL+P2
ouvrit	ouvrir	Ver:IPSim+SG+P3
ouvrît	ouvrir	Ver:SImp+SG+P3
ouvroir	ouvroir	Nom:Mas+SG
ouvroirs	ouvroir	Nom:Mas+PL
ouvrons	ouvrer	Ver:IPre+PL+P1:ImPre+PL+P1
ouvrons	ouvrir	Ver:IPre+PL+P1:ImPre+PL+P1
ouzbek	ouzbek	Adj:InvGen+SG
ouzbek	ouzbek	Nom:InvGen+SG
ouzbek	ouzbek	Nom:Mas+SG
ouzbeks	ouzbek	Adj:InvGen+PL
ouzbeks	ouzbek	Nom:InvGen+PL
ouzo	ouzo	Nom:Mas+SG
ovaire	ovaire	Nom:Mas+SG
ovaires	ovaire	Nom:Mas+PL
ovalbumine	ovalbumine	Nom:Fem+SG
ovale	ovale	Adj:InvGen+SG
ovale	ovale	Nom:Mas+SG
ovale	ovaler	Ver:IPre+SG+P1:IPre+SG+P3:SPre+SG+P1:SPre+SG+P3:ImPre+SG+P2
ovales	ovale	Adj:InvGen+PL
ovales	ovale	Nom:Mas+PL
ovales	ovaler	Ver:IPre+SG+P2:SPre+SG+P2
ovalisant	ovaliser	Ver:PPre
ovalisation	ovalisation	Nom:Fem+SG
ovalisations	ovalisation	Nom:Fem+PL
ovalisée	ovalisé	Adj:Fem+SG
ovalisée	ovaliser	Ver:PPas+Fem+SG
ovalisées	ovalisé	Adj:Fem+PL
ovalisées	ovaliser	Ver:PPas+Fem+PL
ovalisé	ovalisé	Adj:Mas+SG
ovaliser	ovaliser	Ver:Inf
ovalisés	ovalisé	Adj:Mas+PL
ovalisés	ovaliser	Ver:PPas+Mas+PL
ovariectomie	ovariectomie	Nom:Fem+SG
ovarienne	ovarien	Adj:Fem+SG
ovariennes	ovarien	Adj:Fem+PL
ovarien	ovarien	Adj:Mas+SG
ovariens	ovarien	Adj:Mas+PL
ovariotomie	ovariotomie	Nom:Fem+SG
ovarite	ovarite	Nom:Fem+SG
ovate	ovate	Nom:Mas+SG
ovationnaient	ovationner	Ver:IImp+PL+P3
ovationnai	ovationner	Ver:IPSim+SG+P1
ovationnais	ovationner	Ver:IImp+SG+P1:IImp+SG+P2
ovationnait	ovationner	Ver:IImp+SG+P3
ovationnâmes	ovationner	Ver:IPSim+PL+P1
ovationnant	ovationner	Ver:PPre
ovationna	ovationner	Ver:IPSim+SG+P3
ovationnas	ovationner	Ver:IPSim+SG+P2
ovationnassent	ovationner	Ver:SImp+PL+P3
ovationnasse	ovationner	Ver:SImp+SG+P1
ovationnasses	ovationner	Ver:SImp+SG+P2
ovationnassiez	ovationner	Ver:SImp+PL+P2
ovationnassions	ovationner	Ver:SImp+PL+P1
ovationnâtes	ovationner	Ver:IPSim+PL+P2
ovationnât	ovationner	Ver:SImp+SG+P3
ovationnée	ovationner	Ver:PPas+Fem+SG
ovationnées	ovationner	Ver:PPas+Fem+PL
ovationnent	ovationner	Ver:IPre+PL+P3:SPre+PL+P3
ovationne	ovationner	Ver:IPre+SG+P1:IPre+SG+P3:SPre+SG+P1:SPre+SG+P3:ImPre+SG+P2
ovationné	ovationner	Ver:PPas+Mas+SG
ovationneraient	ovationner	Ver:CPre+PL+P3
ovationnerai	ovationner	Ver:IFut+SG+P1
ovationnerais	ovationner	Ver:CPre+SG+P1:CPre+SG+P2
ovationnerait	ovationner	Ver:CPre+SG+P3
ovationnera	ovationner	Ver:IFut+SG+P3
ovationneras	ovationner	Ver:IFut+SG+P2
ovationnèrent	ovationner	Ver:IPSim+PL+P3
ovationnerez	ovationner	Ver:IFut+PL+P2
ovationneriez	ovationner	Ver:CPre+PL+P2
ovationnerions	ovationner	Ver:CPre+PL+P1
ovationnerons	ovationner	Ver:IFut+PL+P1
ovationneront	ovationner	Ver:IFut+PL+P3
ovationner	ovationner	Ver:Inf
ovationnes	ovationner	Ver:IPre+SG+P2:SPre+SG+P2
ovationnés	ovationner	Ver:PPas+Mas+PL
ovationnez	ovationner	Ver:IPre+PL+P2:ImPre+PL+P2
ovationniez	ovationner	Ver:IImp+PL+P2:SPre+PL+P2
ovationnions	ovationner	Ver:IImp+PL+P1:SPre+PL+P1
ovationnons	ovationner	Ver:IPre+PL+P1:ImPre+PL+P1
ovation	ovation	Nom:Fem+SG
ovations	ovation	Nom:Fem+PL
ove	ove	Nom:Mas+SG
overdose	overdose	Nom:Fem+SG
overdoses	overdose	Nom:Fem+PL
ovibos	ovibos	Nom:Mas+InvPL
ovidés	ovidé	Nom:Mas+PL
oviducte	oviducte	Nom:Mas+SG
ovine	ovin	Adj:Fem+SG
oviné	oviné	Nom:Mas+SG
ovines	ovin	Adj:Fem+PL
ovinés	oviné	Nom:Mas+PL
ovin	ovin	Adj:Mas+SG
ovin	ovin	Nom:Mas+SG
ovins	ovin	Adj:Mas+PL
ovins	ovin	Nom:Mas+PL
ovipare	ovipare	Adj:InvGen+SG
ovipare	ovipare	Nom:Mas+SG
ovipares	ovipare	Adj:InvGen+PL
ovipares	ovipare	Nom:Mas+PL
oviparité	oviparité	Nom:Fem+SG
ovipositeur	ovipositeur	Nom:Mas+SG
oviscapte	oviscapte	Nom:Mas+SG
ovni	ovni	Nom:Mas+SG
ovnis	ovni	Nom:Mas+PL
ovocyte	ovocyte	Nom:Mas+SG
ovogenèse	ovogenèse	Nom:Fem+SG
ovogonie	ovogonie	Nom:Fem+SG
ovoïdale	ovoïdal	Adj:Fem+SG
ovoïdales	ovoïdal	Adj:Fem+PL
ovoïdal	ovoïdal	Adj:Mas+SG
ovoïdaux	ovoïdal	Adj:Mas+PL
ovoïde	ovoïde	Adj:InvGen+SG
ovoïdes	ovoïde	Adj:InvGen+PL
ovotide	ovotide	Nom:Mas+SG
ovovivipare	ovovivipare	Adj:InvGen+SG
ovoviviparité	ovoviviparité	Nom:Fem+SG
ovulaient	ovuler	Ver:IImp+PL+P3
ovulai	ovuler	Ver:IPSim+SG+P1
ovulaire	ovulaire	Adj:InvGen+SG
ovulais	ovuler	Ver:IImp+SG+P1:IImp+SG+P2
ovulait	ovuler	Ver:IImp+SG+P3
ovulâmes	ovuler	Ver:IPSim+PL+P1
ovula	ovuler	Ver:IPSim+SG+P3
ovulas	ovuler	Ver:IPSim+SG+P2
ovulassent	ovuler	Ver:SImp+PL+P3
ovulasse	ovuler	Ver:SImp+SG+P1
ovulasses	ovuler	Ver:SImp+SG+P2
ovulassiez	ovuler	Ver:SImp+PL+P2
ovulassions	ovuler	Ver:SImp+PL+P1
ovulâtes	ovuler	Ver:IPSim+PL+P2
ovulation	ovulation	Nom:Fem+SG
ovulations	ovulation	Nom:Fem+PL
ovulatoire	ovulatoire	Adj:InvGen+SG
ovulât	ovuler	Ver:SImp+SG+P3
ovulent	ovuler	Ver:IPre+PL+P3:SPre+PL+P3
ovule	ovule	Nom:Fem+SG
ovule	ovule	Nom:Mas+SG
ovule	ovuler	Ver:IPre+SG+P1:IPre+SG+P3:SPre+SG+P1:SPre+SG+P3:ImPre+SG+P2
ovuleraient	ovuler	Ver:CPre+PL+P3
ovulerai	ovuler	Ver:IFut+SG+P1
ovulerais	ovuler	Ver:CPre+SG+P1:CPre+SG+P2
ovulerait	ovuler	Ver:CPre+SG+P3
ovulera	ovuler	Ver:IFut+SG+P3
ovuleras	ovuler	Ver:IFut+SG+P2
ovulèrent	ovuler	Ver:IPSim+PL+P3
ovulerez	ovuler	Ver:IFut+PL+P2
ovuleriez	ovuler	Ver:CPre+PL+P2
ovulerions	ovuler	Ver:CPre+PL+P1
ovulerons	ovuler	Ver:IFut+PL+P1
ovuleront	ovuler	Ver:IFut+PL+P3
ovuler	ovuler	Ver:Inf
ovules	ovule	Nom:Fem+PL
ovules	ovule	Nom:Mas+PL
ovules	ovuler	Ver:IPre+SG+P2:SPre+SG+P2
ovulez	ovuler	Ver:IPre+PL+P2:ImPre+PL+P2
ovuliez	ovuler	Ver:IImp+PL+P2:SPre+PL+P2
ovulions	ovuler	Ver:IImp+PL+P1:SPre+PL+P1
ovulons	ovuler	Ver:IPre+PL+P1:ImPre+PL+P1
oxacide	oxacide	Nom:Mas+SG
oxalate	oxalate	Nom:Mas+SG
oxalémie	oxalémie	Nom:Fem+SG
oxalique	oxalique	Adj:InvGen+SG
oxalurie	oxalurie	Nom:Fem+SG
oxfordien	oxfordien	Adj:Mas+SG
oxfordien	oxfordien	Nom:Mas+SG
oxford	oxford	Nom:Mas+SG
oxhydrique	oxhydrique	Adj:InvGen+SG
oxhydriques	oxhydrique	Adj:InvGen+PL
oxime	oxime	Nom:Fem+SG
oxonien	oxonien	Adj:Mas+SG
oxonium	oxonium	Nom:Mas+SG
oxyacétylénique	oxyacétylénique	Adj:InvGen+SG
oxyacide	oxyacide	Nom:Mas+SG
oxycarbonée	oxycarboné	Adj:Fem+SG
oxycarbonées	oxycarboné	Adj:Fem+PL
oxycarbonémie	oxycarbonémie	Nom:Fem+SG
oxycarboné	oxycarboné	Adj:Mas+SG
oxycarbonisme	oxycarbonisme	Nom:Mas+SG
oxychlorure	oxychlorure	Nom:Mas+SG
oxycoupage	oxycoupage	Nom:Mas+SG
oxycyanure	oxycyanure	Nom:Mas+SG
oxydable	oxydable	Adj:InvGen+SG
oxydables	oxydable	Adj:InvGen+PL
oxydaient	oxyder	Ver:IImp+PL+P3
oxydai	oxyder	Ver:IPSim+SG+P1
oxydais	oxyder	Ver:IImp+SG+P1:IImp+SG+P2
oxydait	oxyder	Ver:IImp+SG+P3
oxydâmes	oxyder	Ver:IPSim+PL+P1
oxydante	oxydant	Adj:Fem+SG
oxydantes	oxydant	Adj:Fem+PL
oxydant	oxydant	Adj:Mas+SG
oxydant	oxydant	Nom:Mas+SG
oxydant	oxyder	Ver:PPre
oxydants	oxydant	Adj:Mas+PL
oxydants	oxydant	Nom:Mas+PL
oxyda	oxyder	Ver:IPSim+SG+P3
oxydase	oxydase	Nom:Fem+SG
oxydas	oxyder	Ver:IPSim+SG+P2
oxydassent	oxyder	Ver:SImp+PL+P3
oxydasse	oxyder	Ver:SImp+SG+P1
oxydasses	oxyder	Ver:SImp+SG+P2
oxydassiez	oxyder	Ver:SImp+PL+P2
oxydassions	oxyder	Ver:SImp+PL+P1
oxydâtes	oxyder	Ver:IPSim+PL+P2
oxydation	oxydation	Nom:Fem+SG
oxydations	oxydation	Nom:Fem+PL
oxydât	oxyder	Ver:SImp+SG+P3
oxydée	oxyder	Ver:PPas+Fem+SG
oxydées	oxyder	Ver:PPas+Fem+PL
oxydent	oxyder	Ver:IPre+PL+P3:SPre+PL+P3
oxyde	oxyde	Nom:Mas+SG
oxyde	oxyder	Ver:IPre+SG+P1:IPre+SG+P3:SPre+SG+P1:SPre+SG+P3:ImPre+SG+P2
oxydé	oxyder	Ver:PPas+Mas+SG
oxyderaient	oxyder	Ver:CPre+PL+P3
oxyderai	oxyder	Ver:IFut+SG+P1
oxyderais	oxyder	Ver:CPre+SG+P1:CPre+SG+P2
oxyderait	oxyder	Ver:CPre+SG+P3
oxydera	oxyder	Ver:IFut+SG+P3
oxyderas	oxyder	Ver:IFut+SG+P2
oxydèrent	oxyder	Ver:IPSim+PL+P3
oxyderez	oxyder	Ver:IFut+PL+P2
oxyderiez	oxyder	Ver:CPre+PL+P2
oxyderions	oxyder	Ver:CPre+PL+P1
oxyderons	oxyder	Ver:IFut+PL+P1
oxyderont	oxyder	Ver:IFut+PL+P3
oxyder	oxyder	Ver:Inf
oxydes	oxyde	Nom:Mas+PL
oxydes	oxyder	Ver:IPre+SG+P2:SPre+SG+P2
oxydés	oxyder	Ver:PPas+Mas+PL
oxydez	oxyder	Ver:IPre+PL+P2:ImPre+PL+P2
oxydiez	oxyder	Ver:IImp+PL+P2:SPre+PL+P2
oxydions	oxyder	Ver:IImp+PL+P1:SPre+PL+P1
oxydons	oxyder	Ver:IPre+PL+P1:ImPre+PL+P1
oxydoréductase	oxydoréductase	Nom:Fem+SG
oxydoréducteur	oxydoréducteur	Adj:Mas+SG
oxydoréductimétrie	oxydoréductimétrie	Nom:Fem+SG
oxydoréduction	oxydoréduction	Nom:Fem+SG
oxygénable	oxygénable	Adj:InvGen+SG
oxygénant	oxygénant	Adj:Mas+SG
oxygénant	oxygéner	Ver:PPre
oxygénateur	oxygénateur	Nom:Mas+SG
oxygénation	oxygénation	Nom:Fem+SG
oxygénations	oxygénation	Nom:Fem+PL
oxygénée	oxygéné	Adj:Fem+SG
oxygénée	oxygéner	Ver:PPas+Fem+SG
oxygénées	oxygéné	Adj:Fem+PL
oxygénées	oxygéner	Ver:PPas+Fem+PL
oxygènent	oxygéner	Ver:IPre+PL+P3:SPre+PL+P3
oxygéné	oxygéné	Adj:Mas+SG
oxygène	oxygène	Nom:Mas+SG
oxygène	oxygéner	Ver:IPre+SG+P1:IPre+SG+P3:SPre+SG+P1:SPre+SG+P3:ImPre+SG+P2
oxygéné	oxygéner	Ver:PPas+Mas+SG
oxygéner	oxygéner	Ver:Inf
oxygénés	oxygéné	Adj:Mas+PL
oxygènes	oxygéner	Ver:IPre+SG+P2:SPre+SG+P2
oxygénés	oxygéner	Ver:PPas+Mas+PL
oxygénothérapie	oxygénothérapie	Nom:Fem+SG
oxyhémoglobine	oxyhémoglobine	Nom:Fem+SG
oxylithe	oxylithe	Nom:Fem+SG
oxymel	oxymel	Nom:Mas+SG
oxymétrie	oxymétrie	Nom:Fem+SG
oxymoron	oxymoron	Nom:Mas+SG
oxysel	oxysel	Nom:Mas+SG
oxysulfure	oxysulfure	Nom:Mas+SG
oxyton	oxyton	Adj:InvGen+SG
oxyton	oxyton	Nom:Mas+SG
oxyure	oxyure	Nom:Mas+SG
oxyurose	oxyurose	Nom:Fem+SG
oyaient	ouïr	Ver:IImp+PL+P3
oyais	ouïr	Ver:IImp+SG+P1:IImp+SG+P2
oyait	ouïr	Ver:IImp+SG+P3
oyant	ouïr	Ver:PPre
oyat	oyat	Nom:Mas+SG
oye	oye	Int
oyez	ouïr	Ver:IPre+PL+P2:ImPre+PL+P2
oyiez	ouïr	Ver:IImp+PL+P2:SPre+PL+P2
oyions	ouïr	Ver:IImp+PL+P1:SPre+PL+P1
oyons	ouïr	Ver:IPre+PL+P1:ImPre+PL+P1
ozène	ozène	Nom:Mas+SG
ozéneux	ozéneux	Adj:Mas+InvPL
ozéneux	ozéneux	Nom:Mas+InvPL
ozocérite	ozocérite	Nom:Fem+SG
ozokérite	ozokérite	Nom:Fem+SG
ozonateur	ozonateur	Nom:Mas+SG
ozonée	ozoné	Adj:Fem+SG
ozonée	ozoner	Ver:PPas+Fem+SG
ozonées	ozoné	Adj:Fem+PL
ozonées	ozoner	Ver:PPas+Fem+PL
ozone	ozone	Nom:Mas+SG
ozone	ozoner	Ver:IPre+SG+P1:IPre+SG+P3:SPre+SG+P1:SPre+SG+P3:ImPre+SG+P2
ozones	ozone	Nom:Mas+PL
ozones	ozoner	Ver:IPre+SG+P2:SPre+SG+P2
ozoneur	ozoneur	Nom:Mas+SG
ozonide	ozonide	Nom:Mas+SG
ozonisant	ozoniser	Ver:PPre
ozonisateur	ozonisateur	Nom:Mas+SG
ozonisation	ozonisation	Nom:Fem+SG
ozonisations	ozonisation	Nom:Fem+PL
ozonisé	ozoniser	Ver:PPas+Mas+SG
ozoniser	ozoniser	Ver:Inf
ozoniseur	ozoniseur	Nom:Mas+SG
ozonosphère	ozonosphère	Nom:Fem+SG
yeux	oeil	Nom:Mas+PL
